Row Labels,Sum of usa_gross_profit,Sum of usa_gross_income,Sum of budget,Sum of avg_vote,Year,Row Labels,
Cast Away,143632142,233632142,90000000,7.8,2000,Cast Away,Cast+Away
Scary Movie,138019771,157019771,19000000,6.2,2000,Scary Movie,
How the Grinch Stole Christmas,137044825,260044825,123000000,6.2,2000,How the Grinch Stole Christmas,
What Women Want,112811707,182811707,70000000,6.4,2000,What Women Want,
Meet the Parents,111244045,166244045,55000000,7,2000,Meet the Parents,
Mission: Impossible II,90409889,215409889,125000000,6.1,2000,Mission: Impossible II,
Big Momma's House,87559438,117559438,30000000,5.2,2000,Big Momma's House,
Remember the Titans,85654751,115654751,30000000,7.8,2000,Remember the Titans,
Gladiator,84705427,187705427,103000000,8.5,2000,Gladiator,
X-Men,82299718,157299718,75000000,7.4,2000,X-Men,
Traffic,76115725,124115725,48000000,7.6,2000,Traffic,
Erin Brockovich,73595205,125595205,52000000,7.3,2000,Erin Brockovich,
Chicken Run,61834564,106834564,45000000,7,2000,Chicken Run,
Miss Congeniality,61807667,106807667,45000000,6.2,2000,Miss Congeniality,
Bring It On,57379000,68379000,11000000,6,2000,Bring It On,
What Lies Beneath,55464351,155464351,100000000,6.6,2000,What Lies Beneath,
Road Trip,52540777,68540777,16000000,6.4,2000,Road Trip,
Scream 3,49143175,89143175,40000000,5.6,2000,Scream 3,
Snow Day,47020107,60020107,13000000,5.1,2000,Snow Day,
Chocolat,46509363,71509363,25000000,7.2,2000,Chocolat,
Rugrats in Paris: The Movie - Rugrats II,46507756,76507756,30000000,6.1,2000,Rugrats in Paris: The Movie - Rugrats II,
Next Friday,46328603,57328603,11000000,6.2,2000,Next Friday,
The Perfect Storm,42618434,182618434,140000000,6.4,2000,The Perfect Storm,
"Me, Myself & Irene",39570999,90570999,51000000,6.6,2000,"Me, Myself & Irene",
Nutty Professor II: The Klumps,39309890,123309890,84000000,4.4,2000,Nutty Professor II: The Klumps,
"Dude, Where's My Car?",33729800,46729800,13000000,5.5,2000,"Dude, Where's My Car?",
Charlie's Angels,32305545,125305545,93000000,5.5,2000,Charlie's Angels,
Romeo Must Die,30973336,55973336,25000000,6.1,2000,Romeo Must Die,
Final Destination,30331147,53331147,23000000,6.7,2000,Final Destination,
The Cell,28334059,61334059,33000000,6.3,2000,The Cell,
My Dog Skip,28134641,34134641,6000000,7,2000,My Dog Skip,
Space Cowboys,25464773,90464773,65000000,6.4,2000,Space Cowboys,
Shaft,24334258,70334258,46000000,5.9,2000,Shaft,
Unbreakable,20011339,95011339,75000000,7.3,2000,Unbreakable,
"O Brother, Where Art Thou?",19512588,45512588,26000000,7.7,2000,"O Brother, Where Art Thou?",
Where the Heart Is,18772838,33772838,15000000,6.8,2000,Where the Heart Is,
Men of Honor,16818921,48818921,32000000,7.2,2000,Men of Honor,
Memento,16544867,25544867,9000000,8.4,2000,Memento,
Pitch Black,16240659,39240659,23000000,7.1,2000,Pitch Black,
The Whole Nine Yards,15962492,57262492,41300000,6.7,2000,The Whole Nine Yards,
The Family Man,15793305,75793305,60000000,6.8,2000,The Family Man,
Coyote Ugly,15786269,60786269,45000000,5.7,2000,Coyote Ugly,
The Tigger Movie,15554533,45554533,30000000,6.3,2000,The Tigger Movie,
U-571,15122415,77122415,62000000,6.6,2000,U-571,
Frequency,14010278,45010278,31000000,7.3,2000,Frequency,
Gone in Sixty Seconds,11648571,101648571,90000000,6.5,2000,Gone in Sixty Seconds,
Book of Shadows: Blair Witch 2,11437094,26437094,15000000,3.9,2000,Book of Shadows: Blair Witch 2,
Dinosaur,10248063,137748063,127500000,6.5,2000,Dinosaur,
Boiler Room,9970581,16970581,7000000,7,2000,Boiler Room,
Down to You,9069008,20069008,11000000,5,2000,Down to You,
Finding Forrester,8804714,51804714,43000000,7.3,2000,Finding Forrester,
Return to Me,8722798,32722798,24000000,6.9,2000,Return to Me,
Best in Show,8715392,18715392,10000000,7.4,2000,Best in Show,
You Can Count on Me,8216804,9416804,1200000,7.5,2000,You Can Count on Me,
American Psycho,8070285,15070285,7000000,7.6,2000,American Psycho,
Keeping the Faith,8047880,37047880,29000000,6.3,2000,Keeping the Faith,
Urban Legends: Final Cut,7468807,21468807,14000000,4.3,2000,Urban Legends: Final Cut,
Love & Basketball,7459615,27459615,20000000,7.2,2000,Love & Basketball,
The Kid,4691949,69691949,65000000,6.1,2000,The Kid,
The Patriot,3330342,113330342,110000000,7.2,2000,The Patriot,
Pollock,2598593,8598593,6000000,7,2000,Pollock,
The Gift,2008642,12008642,10000000,6.6,2000,The Gift,
Shanghai Noon,1937502,56937502,55000000,6.6,2000,Shanghai Noon,
Bounce,1805288,36805288,35000000,5.7,2000,Bounce,
Rules of Engagement,1335230,61335230,60000000,6.4,2000,Rules of Engagement,
Shadow of the Vampire,293784,8293784,8000000,6.9,2000,Shadow of the Vampire,
The Skulls,46120,35046120,35000000,5.6,2000,The Skulls,
Requiem for a Dream,-864518,3635482,4500000,8.3,2000,Requiem for a Dream,
The Watcher,-1053385,28946615,30000000,5.3,2000,The Watcher,
The Contender,-2127277,17872723,20000000,6.9,2000,The Contender,
The Way of the Gun,-2444339,6055661,8500000,6.7,2000,The Way of the Gun,
High Fidelity,-2712863,27287137,30000000,7.5,2000,High Fidelity,
Animal Factory,-3556195,43805,3600000,6.6,2000,Animal Factory,
Loser,-4381374,15618626,20000000,5.3,2000,Loser,
The Replacements,-5262941,44737059,50000000,6.6,2000,The Replacements,
Vertical Limit,-5756141,69243859,75000000,5.9,2000,Vertical Limit,
28 Days,-5829512,37170488,43000000,6.1,2000,28 Days,
Quills,-6434668,7065332,13500000,7.3,2000,Quills,
Pay It Forward,-6480372,33519628,40000000,7.2,2000,Pay It Forward,
Bamboozled,-7725021,2274979,10000000,6.5,2000,Bamboozled,
Small Time Crooks,-7733641,17266359,25000000,6.7,2000,Small Time Crooks,
The Million Dollar Hotel,-7940011,59989,8000000,5.9,2000,The Million Dollar Hotel,
Dancer in the Dark,-8615964,4184036,12800000,8,2000,Dancer in the Dark,
Cecil B. Demented,-8715354,1284646,10000000,6.3,2000,Cecil B. Demented,
Brother,-9549406,450594,10000000,7.2,2000,Brother,
Nurse Betty,-9829946,25170054,35000000,6.1,2000,Nurse Betty,
Tigerland,-9860308,139692,10000000,7,2000,Tigerland,
Dr. T & the Women,-9886959,13113041,23000000,4.6,2000,Dr. T & the Women,
The Next Best Thing,-10009418,14990582,25000000,4.7,2000,The Next Best Thing,
Bedazzled,-10113020,37886980,48000000,6,2000,Bedazzled,
The Beach,-10214973,39785027,50000000,6.7,2000,The Beach,
The Ladies Man,-10383390,13616610,24000000,5.2,2000,The Ladies Man,
The Emperor's New Groove,-10697313,89302687,100000000,7.3,2000,The Emperor's New Groove,
Ready to Rumble,-11605673,12394327,24000000,5.4,2000,Ready to Rumble,
Center Stage,-11799075,17200925,29000000,6.7,2000,Center Stage,
Highlander: Endgame,-12188142,12811858,25000000,4.6,2000,Highlander: Endgame,
Boys and Girls,-13200348,21799652,35000000,5.4,2000,Boys and Girls,
102 Dalmatians,-18042974,66957026,85000000,4.9,2000,102 Dalmatians,
Reindeer Games,-18631005,23368995,42000000,5.8,2000,Reindeer Games,
Gossip,-18891180,5108820,24000000,5.9,2000,Gossip,
Dracula 2000,-20977233,33022767,54000000,4.9,2000,Dracula 2000,
Drowning Mona,-21493236,15506764,37000000,5.7,2000,Drowning Mona,
Hollow Man,-21790660,73209340,95000000,5.8,2000,Hollow Man,
The Yards,-23110648,889352,24000000,6.4,2000,The Yards,
Hanging Up,-23949770,36050230,60000000,4.9,2000,Hanging Up,
Under Suspicion,-24739438,260562,25000000,6.5,2000,Under Suspicion,
Autumn in New York,-27238085,37761915,65000000,5.7,2000,Autumn in New York,
Almost Famous,-27465150,32534850,60000000,7.9,2000,Almost Famous,
Dungeons & Dragons,-29608030,15391970,45000000,3.6,2000,Dungeons & Dragons,
The Art of War,-29791401,30208599,60000000,5.7,2000,The Art of War,
Proof of Life,-32401069,32598931,65000000,6.2,2000,Proof of Life,
Lost Souls,-33184747,16815253,50000000,4.8,2000,Lost Souls,
Wonder Boys,-35606443,19393557,55000000,7.2,2000,Wonder Boys,
Bless the Child,-35618506,29381494,65000000,5.1,2000,Bless the Child,
Bait,-35674873,15325127,51000000,5.8,2000,Bait,
Mission to Mars,-39116593,60883407,100000000,5.7,2000,Mission to Mars,
All the Pretty Horses,-41459647,15540353,57000000,5.8,2000,All the Pretty Horses,
The Road to El Dorado,-44136258,50863742,95000000,6.9,2000,The Road to El Dorado,
Thirteen Days,-45407911,34592089,80000000,7.3,2000,Thirteen Days,
Little Nicky,-45535225,39464775,85000000,5.3,2000,Little Nicky,
The 6th Day,-47395720,34604280,82000000,5.9,2000,The 6th Day,
The Flintstones in Viva Rock Vegas,-47731725,35268275,83000000,3.6,2000,The Flintstones in Viva Rock Vegas,
Get Carter,-48632818,14967182,63600000,5.2,2000,Get Carter,
The Legend of Bagger Vance,-49080832,30919168,80000000,6.7,2000,The Legend of Bagger Vance,
The Adventures of Rocky & Bullwinkle,-49994180,26005820,76000000,4.2,2000,The Adventures of Rocky & Bullwinkle,
Battlefield Earth,-51528315,21471685,73000000,2.5,2000,Battlefield Earth,
Titan A.E.,-52246574,22753426,75000000,6.6,2000,Titan A.E.,
Red Planet,-62519110,17480890,80000000,5.7,2000,Red Planet,
Supernova,-75769545,14230455,90000000,4.9,2000,Supernova,
The Lord of the Rings: The Fellowship of the Ring,222544750,315544750,93000000,8.8,2001,The Lord of the Rings: The Fellowship of the Ring,
Shrek,207665011,267665011,60000000,7.8,2001,Shrek,
Harry Potter and the Sorcerer's Stone,193087620,318087620,125000000,7.6,2001,Harry Potter and the Sorcerer's Stone,
"Monsters, Inc.",174916256,289916256,115000000,8,2001,"Monsters, Inc.",
Rush Hour 2,136164286,226164286,90000000,6.6,2001,Rush Hour 2,
American Pie 2,115103595,145103595,30000000,6.4,2001,American Pie 2,
A Beautiful Mind,112742341,170742341,58000000,8.2,2001,A Beautiful Mind,
The Fast and the Furious,106533925,144533925,38000000,6.8,2001,The Fast and the Furious,
The Mummy Returns,104019785,202019785,98000000,6.3,2001,The Mummy Returns,
Ocean's Eleven,98417150,183417150,85000000,7.7,2001,Ocean's Eleven,
Jurassic Park III,88171875,181171875,93000000,5.9,2001,Jurassic Park III,
The Princess Diaries,82248956,108248956,26000000,6.3,2001,The Princess Diaries,
Planet of the Apes,80011740,180011740,100000000,5.7,2001,Planet of the Apes,
The Others,79522687,96522687,17000000,7.6,2001,The Others,
Legally Blonde,78520674,96520674,18000000,6.3,2001,Legally Blonde,
Hannibal,78092268,165092268,87000000,6.8,2001,Hannibal,
Save the Last Dance,78057006,91057006,13000000,6.2,2001,Save the Last Dance,
Spy Kids,77719001,112719001,35000000,5.5,2001,Spy Kids,
Pearl Harbor,58542554,198542554,140000000,6.2,2001,Pearl Harbor,
Jimmy Neutron: Boy Genius,50936232,80936232,30000000,6,2001,Jimmy Neutron: Boy Genius,
America's Sweethearts,47607673,93607673,46000000,5.7,2001,America's Sweethearts,
Bridget Jones's Diary,46543427,71543427,25000000,6.7,2001,Bridget Jones's Diary,
Dr. Dolittle 2,42952899,112952899,70000000,4.7,2001,Dr. Dolittle 2,
In the Bedroom,34230604,35930604,1700000,7.4,2001,In the Bedroom,
Cats & Dogs,33385515,93385515,60000000,5.1,2001,Cats & Dogs,
Vanilla Sky,32618344,100618344,68000000,6.9,2001,Vanilla Sky,
Training Day,31631907,76631907,45000000,7.7,2001,Training Day,
The Royal Tenenbaums,31364010,52364010,21000000,7.6,2001,The Royal Tenenbaums,
Shallow Hal,30839203,70839203,40000000,5.9,2001,Shallow Hal,
Jeepers Creepers,27904175,37904175,10000000,6.2,2001,Jeepers Creepers,
Monster's Ball,27273922,31273922,4000000,7,2001,Monster's Ball,
Scary Movie 2,26308997,71308997,45000000,5.3,2001,Scary Movie 2,
The Wedding Planner,25400856,60400856,35000000,5.3,2001,The Wedding Planner,
Not Another Teen Movie,23252284,38252284,15000000,5.7,2001,Not Another Teen Movie,
Serendipity,22294317,50294317,28000000,6.9,2001,Serendipity,
Gosford Park,21508615,41308615,19800000,7.2,2001,Gosford Park,
Behind Enemy Lines,18856790,58856790,40000000,6.4,2001,Behind Enemy Lines,
I Am Sam,18311852,40311852,22000000,7.7,2001,I Am Sam,
Zoolander,17172250,45172250,28000000,6.5,2001,Zoolander,
Black Hawk Down,16638745,108638745,92000000,7.7,2001,Black Hawk Down,
Lara Croft: Tomb Raider,16168070,131168070,115000000,5.8,2001,Lara Croft: Tomb Raider,
Super Troopers,15492362,18492362,3000000,7.1,2001,Super Troopers,
Down to Earth,15186502,64186502,49000000,5.5,2001,Down to Earth,
Along Came a Spider,14078174,74078174,60000000,6.4,2001,Along Came a Spider,
Corky Romano,12980304,23980304,11000000,4.7,2001,Corky Romano,
Baby Boy,12734552,28734552,16000000,6.4,2001,Baby Boy,
Kiss of the Dragon,11845124,36845124,25000000,6.6,2001,Kiss of the Dragon,
How High,11178740,31178740,20000000,6.3,2001,How High,
O,11025437,16025437,5000000,6.1,2001,O,
The Animal,10743062,57743062,47000000,4.8,2001,The Animal,
The Mexican,9845033,66845033,57000000,6.1,2001,The Mexican,
Joe Dirt,9387695,27087695,17700000,6,2001,Joe Dirt,
Rat Race,8618055,56618055,48000000,6.4,2001,Rat Race,
Hard Ball,8222729,40222729,32000000,6.4,2001,Hard Ball,
Jay and Silent Bob Strike Back,8085147,30085147,22000000,6.8,2001,Jay and Silent Bob Strike Back,
Moulin Rouge!,7386607,57386607,50000000,7.6,2001,Moulin Rouge!,
Kissing Jessica Stein,6025722,7025722,1000000,6.4,2001,Kissing Jessica Stein,
The Deep End,5823109,8823109,3000000,6.5,2001,The Deep End,
Heartbreakers,5336607,40336607,35000000,6.2,2001,Heartbreakers,
Don't Say a Word,5001642,55001642,50000000,6.3,2001,Don't Say a Word,
Crocodile Dundee in Los Angeles,4485682,25635682,21150000,4.8,2001,Crocodile Dundee in Los Angeles,
Someone Like You...,4343067,27343067,23000000,6.1,2001,Someone Like You...,
Crazy/Beautiful,3937988,16937988,13000000,6.5,2001,Crazy/Beautiful,
The Score,3107711,71107711,68000000,6.8,2001,The Score,
Tomcats,2558739,13558739,11000000,5.4,2001,Tomcats,
Jason X,2121555,13121555,11000000,4.4,2001,Jason X,
Frailty,2110448,13110448,11000000,7.2,2001,Frailty,
Exit Wounds,1758599,51758599,50000000,5.6,2001,Exit Wounds,
Tape,390475,490475,100000,7.3,2001,Tape,
Made,313300,5313300,5000000,6.4,2001,Made,
Freddy Got Fingered,254993,14254993,14000000,4.6,2001,Freddy Got Fingered,
Iris,94617,5594617,5500000,7,2001,Iris,
Blow,-9225,52990775,53000000,7.6,2001,Blow,
Thir13en Ghosts,-132040,41867960,42000000,5.6,2001,Thir13en Ghosts,
Ghost World,-782151,6217849,7000000,7.3,2001,Ghost World,
Kate & Leopold,-878141,47121859,48000000,6.4,2001,Kate & Leopold,
Joy Ride,-1025081,21974919,23000000,6.6,2001,Joy Ride,
The Believer,-1083075,416925,1500000,7.2,2001,The Believer,
Session 9,-1121824,378176,1500000,6.4,2001,Session 9,
Saving Silverman,-2597970,19402030,22000000,5.9,2001,Saving Silverman,
Hedwig and the Angry Inch,-2932688,3067312,6000000,7.7,2001,Hedwig and the Angry Inch,
From Hell,-3397434,31602566,35000000,6.8,2001,From Hell,
Head Over Heels,-3575530,10424470,14000000,5.5,2001,Head Over Heels,
Pootie Tang,-3686417,3313583,7000000,5.3,2001,Pootie Tang,
The Grey Zone,-4482128,517872,5000000,7,2001,The Grey Zone,
Donnie Darko,-4521507,1478493,6000000,8,2001,Donnie Darko,
Wet Hot American Summer,-4704794,295206,5000000,6.6,2001,Wet Hot American Summer,
The One,-5094254,43905746,49000000,5.9,2001,The One,
Novocaine,-5963318,2036682,8000000,5.8,2001,Novocaine,
Hearts in Atlantis,-6814219,24185781,31000000,6.9,2001,Hearts in Atlantis,
The Tailor of Panama,-7270258,13729742,21000000,6.1,2001,The Tailor of Panama,
Mulholland Dr.,-7779757,7220243,15000000,8,2001,Mulholland Dr.,
Birthday Girl,-7857424,5142576,13000000,6.1,2001,Birthday Girl,
Bubble Boy,-7992102,5007898,13000000,5.6,2001,Bubble Boy,
A Knight's Tale,-8430298,56569702,65000000,6.9,2001,A Knight's Tale,
Valentine,-8615864,20384136,29000000,4.9,2001,Valentine,
Out Cold,-10093606,13906394,24000000,6.4,2001,Out Cold,
Get Over It,-10423536,11576464,22000000,5.7,2001,Get Over It,
Life as a House,-11332730,15667270,27000000,7.5,2001,Life as a House,
One Night at McCool's,-11709327,6290673,18000000,6.1,2001,One Night at McCool's,
The Glass House,-11849741,18150259,30000000,5.8,2001,The Glass House,
The Man Who Wasn't There,-12495743,7504257,20000000,7.5,2001,The Man Who Wasn't There,
The Musketeer,-12926360,27073640,40000000,4.9,2001,The Musketeer,
Sugar & Spice,-13694899,13305101,27000000,5.7,2001,Sugar & Spice,
Summer Catch,-14246447,19753553,34000000,5.1,2001,Summer Catch,
Sweet November,-14711897,25288103,40000000,6.7,2001,Sweet November,
The Pledge,-15266911,19733089,35000000,6.8,2001,The Pledge,
Heist,-15489159,23510841,39000000,6.5,2001,Heist,
Black Knight,-16573029,33426971,50000000,4.9,2001,Black Knight,
Enemy at the Gates,-16598242,51401758,68000000,7.6,2001,Enemy at the Gates,
K-PAX,-17661515,50338485,68000000,7.4,2001,K-PAX,
Glitter,-17725593,4274407,22000000,2.2,2001,Glitter,
Riding in Cars with Boys,-17834464,30165536,48000000,6.5,2001,Riding in Cars with Boys,
Antitrust,-18671906,11328094,30000000,6.1,2001,Antitrust,
Ghosts of Mars,-19290360,8709640,28000000,4.9,2001,Ghosts of Mars,
Say It Isn't So,-19479607,5520393,25000000,5,2001,Say It Isn't So,
A.I. Artificial Intelligence,-21383311,78616689,100000000,7.2,2001,A.I. Artificial Intelligence,
American Outlaws,-21657210,13342790,35000000,6,2001,American Outlaws,
Impostor,-23714824,6285176,30000000,6.2,2001,Impostor,
Josie and the Pussycats,-24728985,14271015,39000000,5.4,2001,Josie and the Pussycats,
Original Sin,-25465779,16534221,42000000,6.1,2001,Original Sin,
The Curse of the Jade Scorpion,-25482809,7517191,33000000,6.7,2001,The Curse of the Jade Scorpion,
The Shipping News,-26565784,11434216,38000000,6.7,2001,The Shipping News,
What's the Worst That Could Happen?,-27730166,32269834,60000000,5.5,2001,What's the Worst That Could Happen?,
Angel Eyes,-28825782,24174218,53000000,5.6,2001,Angel Eyes,
Domestic Disturbance,-29753905,45246095,75000000,5.6,2001,Domestic Disturbance,
Just Visiting,-30218461,4781539,35000000,5.8,2001,Just Visiting,
Captain Corelli's Mandolin,-31456105,25543895,57000000,5.9,2001,Captain Corelli's Mandolin,
Swordfish,-32227031,69772969,102000000,6.5,2001,Swordfish,
Bandits,-33424859,41575141,75000000,6.5,2001,Bandits,
15 Minutes,-35596448,24403552,60000000,6.1,2001,15 Minutes,
Atlantis: The Lost Empire,-35943528,84056472,120000000,6.9,2001,Atlantis: The Lost Empire,
Rock Star,-39991718,17008282,57000000,6.3,2001,Rock Star,
Evolution,-41654506,38345494,80000000,6.1,2001,Evolution,
The Majestic,-44192734,27807266,72000000,6.9,2001,The Majestic,
3000 Miles to Graceland,-46250041,15749959,62000000,6,2001,3000 Miles to Graceland,
Ali,-48796895,58203105,107000000,6.8,2001,Ali,
Spy Game,-52637440,62362560,115000000,7.1,2001,Spy Game,
The Last Castle,-53755940,18244060,72000000,7,2001,The Last Castle,
Osmosis Jones,-56403089,13596911,70000000,6.3,2001,Osmosis Jones,
Driven,-61279935,32720065,94000000,4.6,2001,Driven,
Monkeybone,-69588001,5411999,75000000,4.7,2001,Monkeybone,
Final Fantasy: The Spirits Within,-104868170,32131830,137000000,6.4,2001,Final Fantasy: The Spirits Within,
Spider-Man,268022860,407022860,139000000,7.3,2002,Spider-Man,
The Lord of the Rings: The Two Towers,248551365,342551365,94000000,8.7,2002,The Lord of the Rings: The Two Towers,
My Big Fat Greek Wedding,236438208,241438208,5000000,6.5,2002,My Big Fat Greek Wedding,
Star Wars: Episode II - Attack of the Clones,195676740,310676740,115000000,6.5,2002,Star Wars: Episode II - Attack of the Clones,
Harry Potter and the Chamber of Secrets,162450136,262450136,100000000,7.4,2002,Harry Potter and the Chamber of Secrets,
Signs,155966634,227966634,72000000,6.7,2002,Signs,
Austin Powers in Goldmember,150307889,213307889,63000000,6.2,2002,Austin Powers in Goldmember,
Chicago,125687518,170687518,45000000,7.1,2002,Chicago,
Ice Age,117387405,176387405,59000000,7.5,2002,Ice Age,
Catch Me If You Can,112615351,164615351,52000000,8.1,2002,Catch Me If You Can,
Sweet Home Alabama,97223418,127223418,30000000,6.2,2002,Sweet Home Alabama,
The Ring,81128133,129128133,48000000,7.1,2002,The Ring,
Mr. Deeds,76293452,126293452,50000000,5.8,2002,Mr. Deeds,
8 Mile,75750901,116750901,41000000,7.1,2002,8 Mile,
The Santa Clause 2,74236327,139236327,65000000,5.6,2002,The Santa Clause 2,
xXx,72109382,142109382,70000000,5.9,2002,xXx,
Scooby-Doo,69294164,153294164,84000000,5.1,2002,Scooby-Doo,
Lilo & Stitch,65794338,145794338,80000000,7.2,2002,Lilo & Stitch,
Barbershop,63782105,75782105,12000000,6.3,2002,Barbershop,
The Bourne Identity,61661683,121661683,60000000,7.9,2002,The Bourne Identity,
Men in Black II,53735288,193735288,140000000,6.2,2002,Men in Black II,
The Rookie,53600072,75600072,22000000,6.9,2002,The Rookie,
The Sum of All Fears,50907036,118907036,68000000,6.4,2002,The Sum of All Fears,
Panic Room,48397334,96397334,48000000,6.8,2002,Panic Room,
Snow Dogs,48172560,81172560,33000000,5.2,2002,Snow Dogs,
Spy Kids 2: Island of Lost Dreams,47846429,85846429,38000000,5.2,2002,Spy Kids 2: Island of Lost Dreams,
Divine Secrets of the Ya-Ya Sisterhood,42599016,69599016,27000000,6.1,2002,Divine Secrets of the Ya-Ya Sisterhood,
Maid in Manhattan,39011225,94011225,55000000,5.3,2002,Maid in Manhattan,
Drumline,36399184,56399184,20000000,5.8,2002,Drumline,
John Q,35756802,71756802,36000000,7.1,2002,John Q,
About Schmidt,35016287,65016287,30000000,7.1,2002,About Schmidt,
Phone Booth,33566212,46566212,13000000,7,2002,Phone Booth,
Big Fat Liar,33360547,48360547,15000000,5.4,2002,Big Fat Liar,
Two Weeks Notice,33354851,93354851,60000000,6.1,2002,Two Weeks Notice,
The Scorpion King,31047077,91047077,60000000,5.5,2002,The Scorpion King,
Minority Report,30072926,132072926,102000000,7.6,2002,Minority Report,
A Walk to Remember,29481092,41281092,11800000,7.4,2002,A Walk to Remember,
Return to Never Land,28430258,48430258,20000000,5.8,2002,Return to Never Land,
Blade II,28348319,82348319,54000000,6.7,2002,Blade II,
Crossroads,25191304,37191304,12000000,3.5,2002,Crossroads,
Road to Perdition,24454762,104454762,80000000,7.7,2002,Road to Perdition,
The Master of Disguise,24388794,40388794,16000000,3.4,2002,The Master of Disguise,
Friday After Next,23253609,33253609,10000000,5.8,2002,Friday After Next,
Orange County,23076018,41076018,18000000,6.2,2002,Orange County,
Changing Lanes,21818548,66818548,45000000,6.4,2002,Changing Lanes,
Like Mike,21432760,51432760,30000000,5.3,2002,Like Mike,
Insomnia,21355513,67355513,46000000,7.2,2002,Insomnia,
40 Days and 40 Nights,20950822,37950822,17000000,5.6,2002,40 Days and 40 Nights,
The Banger Sisters,20307416,30307416,10000000,5.6,2002,The Banger Sisters,
Cabin Fever,19658188,21158188,1500000,5.7,2002,Cabin Fever,
One Hour Photo,19597131,31597131,12000000,6.8,2002,One Hour Photo,
The Count of Monte Cristo,19234062,54234062,35000000,7.8,2002,The Count of Monte Cristo,
Die Another Day,18942139,160942139,142000000,6.1,2002,Die Another Day,
Swimfan,18564995,28564995,10000000,5.1,2002,Swimfan,
Halloween: Resurrection,17354442,30354442,13000000,4,2002,Halloween: Resurrection,
The New Guy,16760152,29760152,13000000,5.9,2002,The New Guy,
The Hours,16675994,41675994,25000000,7.5,2002,The Hours,
National Lampoon's Van Wilder,16305259,21305259,5000000,6.4,2002,National Lampoon's Van Wilder,
Blue Crush,15390647,40390647,25000000,5.7,2002,Blue Crush,
Red Dragon,15149898,93149898,78000000,7.2,2002,Red Dragon,
The Wild Thornberrys Movie,15108697,40108697,25000000,5.6,2002,The Wild Thornberrys Movie,
Undercover Brother,14089928,39089928,25000000,5.8,2002,Undercover Brother,
Frida,13885000,25885000,12000000,7.4,2002,Frida,
Darkness,11563442,22163442,10600000,5.5,2002,Darkness,
About a Boy,11385278,41385278,30000000,7,2002,About a Boy,
Clockstoppers,10989956,36989956,26000000,5.2,2002,Clockstoppers,
All About the Benjamins,10916319,25916319,15000000,5.9,2002,All About the Benjamins,
Ghost Ship,10113491,30113491,20000000,5.5,2002,Ghost Ship,
Antwone Fisher,8578145,21078145,12500000,7.3,2002,Antwone Fisher,
25th Hour,8084595,13084595,5000000,7.6,2002,25th Hour,
Resident Evil,7119709,40119709,33000000,6.7,2002,Resident Evil,
Kung Pow: Enter the Fist,6037962,16037962,10000000,6.2,2002,Kung Pow: Enter the Fist,
The Good Girl,6018296,14018296,8000000,6.4,2002,The Good Girl,
The Transporter,4296447,25296447,21000000,6.8,2002,The Transporter,
Tuck Everlasting,4161999,19161999,15000000,6.6,2002,Tuck Everlasting,
Narc,3965659,10465659,6500000,7.1,2002,Narc,
The Mothman Prophecies,3746370,35746370,32000000,6.4,2002,The Mothman Prophecies,
Adaptation.,3498520,22498520,19000000,7.7,2002,Adaptation.,
We Were Soldiers,3122718,78122718,75000000,7.2,2002,We Were Soldiers,
Unfaithful,2775765,52775765,50000000,6.7,2002,Unfaithful,
Half Past Dead,2567860,15567860,13000000,4.7,2002,Half Past Dead,
The Rules of Attraction,2532619,6532619,4000000,6.7,2002,The Rules of Attraction,
Far from Heaven,2401849,15901849,13500000,7.3,2002,Far from Heaven,
Enough,2007742,40007742,38000000,5.8,2002,Enough,
The Emperor's Club,1618751,14118751,12500000,6.9,2002,The Emperor's Club,
White Oleander,357770,16357770,16000000,7.1,2002,White Oleander,
Bubba Ho-Tep,239183,1239183,1000000,7,2002,Bubba Ho-Tep,
Secretary,59680,4059680,4000000,7,2002,Secretary,
May,-349723,150277,500000,6.6,2002,May,
High Crimes,-456083,41543917,42000000,6.4,2002,High Crimes,
Spun,-1588881,411119,2000000,6.8,2002,Spun,
Sorority Boys,-1799968,10200032,12000000,5.5,2002,Sorority Boys,
The Pianist,-2427423,32572577,35000000,8.5,2002,The Pianist,
Gerry,-3245317,254683,3500000,6.1,2002,Gerry,
They,-4159158,12840842,17000000,4.8,2002,They,
Igby Goes Down,-4222535,4777465,9000000,6.9,2002,Igby Goes Down,
Queen of the Damned,-4663200,30336800,35000000,5.3,2002,Queen of the Damned,
Auto Focus,-4936804,2063196,7000000,6.6,2002,Auto Focus,
Dark Blue,-5749699,9250301,15000000,6.6,2002,Dark Blue,
The Importance of Being Earnest,-6615071,8384929,15000000,6.8,2002,The Importance of Being Earnest,
Spirit: Stallion of the Cimarron,-6719883,73280117,80000000,7.1,2002,Spirit: Stallion of the Cimarron,
Punch-Drunk Love,-7155784,17844216,25000000,7.3,2002,Punch-Drunk Love,
Undisputed,-7235343,12764657,20000000,6.2,2002,Undisputed,
The Guru,-7904494,3095506,11000000,5.3,2002,The Guru,
Nicholas Nickleby,-8412827,1587173,10000000,7.1,2002,Nicholas Nickleby,
Slackers,-8714059,5285941,14000000,5.4,2002,Slackers,
The Tuxedo,-9452002,50547998,60000000,5.4,2002,The Tuxedo,
The Dangerous Lives of Altar Boys,-10184136,1815864,12000000,7,2002,The Dangerous Lives of Altar Boys,
Eight Crazy Nights,-10413402,23586598,34000000,5.4,2002,Eight Crazy Nights,
Stealing Harvard,-10963594,14036406,25000000,5.2,2002,Stealing Harvard,
Hollywood Ending,-11149247,4850753,16000000,6.6,2002,Hollywood Ending,
Boat Trip,-11399874,8600126,20000000,4.9,2002,Boat Trip,
Welcome to Collinwood,-11663380,336620,12000000,6.4,2002,Welcome to Collinwood,
Serving Sara,-12069815,16930185,29000000,5.4,2002,Serving Sara,
Eight Legged Freaks,-12677394,17322606,30000000,5.4,2002,Eight Legged Freaks,
Confessions of a Dangerous Mind,-13992282,16007718,30000000,7,2002,Confessions of a Dangerous Mind,
Moonlight Mile,-14164144,6835856,21000000,6.6,2002,Moonlight Mile,
Possession,-14886267,10113733,25000000,6.3,2002,Possession,
The Four Feathers,-16693834,18306166,35000000,6.5,2002,The Four Feathers,
Star Trek: Nemesis,-16745591,43254409,60000000,6.4,2002,Star Trek: Nemesis,
Reign of Fire,-16938018,43061982,60000000,6.2,2002,Reign of Fire,
The Quiet American,-17011199,12988801,30000000,7,2002,The Quiet American,
The Salton Sea,-17235446,764554,18000000,7.1,2002,The Salton Sea,
City by the Sea,-17551000,22449000,40000000,6.1,2002,City by the Sea,
Murder by Numbers,-18054251,31945749,50000000,6.2,2002,Murder by Numbers,
The Sweetest Thing,-18281836,24718164,43000000,5.2,2002,The Sweetest Thing,
Equilibrium,-18796206,1203794,20000000,7.4,2002,Equilibrium,
People I Know,-21873207,126793,22000000,5.5,2002,People I Know,
Gangs of New York,-22188000,77812000,100000000,7.5,2002,Gangs of New York,
Trapped,-22926749,7073251,30000000,6.2,2002,Trapped,
The Time Machine,-23167506,56832494,80000000,6,2002,The Time Machine,
Blood Work,-23764919,26235081,50000000,6.4,2002,Blood Work,
Life or Something Like It,-25551411,14448589,40000000,5.8,2002,Life or Something Like It,
Feardotcom,-26741751,13258249,40000000,3.4,2002,Feardotcom,
Analyze That,-27869373,32130627,60000000,5.9,2002,Analyze That,
Dragonfly,-29676600,30323400,60000000,6.1,2002,Dragonfly,
Solaris,-32026618,14973382,47000000,6.2,2002,Solaris,
Big Trouble,-32732693,7267307,40000000,6.5,2002,Big Trouble,
I Spy,-36438863,33561137,70000000,5.4,2002,I Spy,
Below,-39394438,605562,40000000,6.1,2002,Below,
Bad Company,-39839839,30160161,70000000,5.6,2002,Bad Company,
Death to Smoochy,-41635309,8364691,50000000,6.4,2002,Death to Smoochy,
Collateral Damage,-44922743,40077257,85000000,5.5,2002,Collateral Damage,
Showtime,-46917288,38082712,85000000,5.5,2002,Showtime,
Hart's War,-50922359,19077641,70000000,6.3,2002,Hart's War,
Rollerball,-51009202,18990798,70000000,3.1,2002,Rollerball,
D-Tox,-54920839,79161,55000000,5.3,2002,D-Tox,
Stuart Little 2,-55043194,64956806,120000000,5.5,2002,Stuart Little 2,
Ballistic: Ecks vs. Sever,-55692037,14307963,70000000,3.7,2002,Ballistic: Ecks vs. Sever,
K-19: The Widowmaker,-64831034,35168966,100000000,6.7,2002,K-19: The Widowmaker,
Windtalkers,-74085932,40914068,115000000,6.1,2002,Windtalkers,
The Adventures of Pluto Nash,-95579920,4420080,100000000,3.8,2002,The Adventures of Pluto Nash,
Treasure Planet,-101823217,38176783,140000000,7.2,2002,Treasure Planet,
Finding Nemo,286843261,380843261,94000000,8.1,2003,Finding Nemo,
The Lord of the Rings: The Return of the King,283845905,377845905,94000000,8.9,2003,The Lord of the Rings: The Return of the King,
Pirates of the Caribbean: The Curse of the Black Pearl,165413918,305413918,140000000,8,2003,Pirates of the Caribbean: The Curse of the Black Pearl,
Bruce Almighty,161829261,242829261,81000000,6.8,2003,Bruce Almighty,
Elf,141626840,174626840,33000000,6.9,2003,Elf,
The Matrix Reloaded,131576461,281576461,150000000,7.2,2003,The Matrix Reloaded,
X2,104949694,214949694,110000000,7.4,2003,X2,
Bringing Down the House,99716677,132716677,33000000,5.6,2003,Bringing Down the House,
Cheaper by the Dozen,98614544,138614544,40000000,5.9,2003,Cheaper by the Dozen,
Freaky Friday,90230332,110230332,20000000,6.2,2003,Freaky Friday,
Spy Kids 3: Game Over,73761982,111761982,38000000,4.3,2003,Spy Kids 3: Game Over,
The Texas Chainsaw Massacre,71071655,80571655,9500000,6.2,2003,The Texas Chainsaw Massacre,
Mystic River,65135191,90135191,25000000,7.9,2003,Mystic River,
Scary Movie 3,62003217,110003217,48000000,5.5,2003,Scary Movie 3,
Anger Management,60645823,135645823,75000000,6.3,2003,Anger Management,
How to Lose a Guy in 10 Days,55813373,105813373,50000000,6.4,2003,How to Lose a Guy in 10 Days,
Freddy vs. Jason,52622655,82622655,30000000,5.7,2003,Freddy vs. Jason,
Old School,51585093,75585093,24000000,7.1,2003,Old School,
2 Fast 2 Furious,51154901,127154901,76000000,5.9,2003,2 Fast 2 Furious,
American Wedding,49565114,104565114,55000000,6.3,2003,American Wedding,
Holes,47406573,67406573,20000000,7,2003,Holes,
The School of Rock,46261177,81261177,35000000,7.1,2003,The School of Rock,
The Italian Job,46128601,106128601,60000000,7,2003,The Italian Job,
"Legally Blonde 2: Red, White & Blonde",45186328,90186328,45000000,4.8,2003,"Legally Blonde 2: Red, White & Blonde",
Something's Gotta Give,44728738,124728738,80000000,6.7,2003,Something's Gotta Give,
Daddy Day Care,44297061,104297061,60000000,5.6,2003,Daddy Day Care,
Lost in Translation,40585453,44585453,4000000,7.7,2003,Lost in Translation,
Kill Bill: Vol. 1,40099045,70099045,30000000,8.1,2003,Kill Bill: Vol. 1,
Just Married,38127162,56127162,18000000,5.5,2003,Just Married,
Bad Santa,37060328,60060328,23000000,7,2003,Bad Santa,
S.W.A.T.,36934650,116934650,80000000,6,2003,S.W.A.T.,
Open Range,36331254,58331254,22000000,7.4,2003,Open Range,
Seabiscuit,33277854,120277854,87000000,7.3,2003,Seabiscuit,
Open Water,30110863,30610863,500000,5.7,2003,Open Water,
Underworld,29970690,51970690,22000000,7,2003,Underworld,
The Jungle Book 2,27901582,47901582,20000000,5.4,2003,The Jungle Book 2,
Once Upon a Time in Mexico,27359780,56359780,29000000,6.4,2003,Once Upon a Time in Mexico,
Monster,26469210,34469210,8000000,7.3,2003,Monster,
The Lizzie McGuire Movie,25734455,42734455,17000000,5.5,2003,The Lizzie McGuire Movie,
Under the Tuscan Sun,25610723,43610723,18000000,6.8,2003,Under the Tuscan Sun,
Daredevil,24543518,102543518,78000000,5.3,2003,Daredevil,
Identity,24159536,52159536,28000000,7.3,2003,Identity,
Darkness Falls,21551396,32551396,11000000,5,2003,Darkness Falls,
Calendar Girls,21041759,31041759,10000000,6.9,2003,Calendar Girls,
Final Destination 2,20961214,46961214,26000000,6.2,2003,Final Destination 2,
Agent Cody Banks,19938330,47938330,28000000,5.1,2003,Agent Cody Banks,
Love Actually,19696144,59696144,40000000,7.6,2003,Love Actually,
Gothika,19694580,59694580,40000000,5.8,2003,Gothika,
Malibu's Most Wanted,19432201,34432201,15000000,5.2,2003,Malibu's Most Wanted,
Jeepers Creepers 2,18667218,35667218,17000000,5.6,2003,Jeepers Creepers 2,
Radio,17333738,52333738,35000000,6.9,2003,Radio,
Uptown Girls,17182494,37182494,20000000,6.2,2003,Uptown Girls,
Cold Mountain,16636509,95636509,79000000,7.2,2003,Cold Mountain,
Honey,12308417,30308417,18000000,5.4,2003,Honey,
Secondhand Lions,12070939,42070939,30000000,7.5,2003,Secondhand Lions,
What a Girl Wants,11105433,36105433,25000000,5.8,2003,What a Girl Wants,
Shanghai Knights,10476872,60476872,50000000,6.2,2003,Shanghai Knights,
Cradle 2 the Grave,9712347,34712347,25000000,5.8,2003,Cradle 2 the Grave,
Bad Boys II,8608444,138608444,130000000,6.6,2003,Bad Boys II,
Dumb and Dumberer: When Harry Met Lloyd,7276465,26276465,19000000,3.4,2003,Dumb and Dumberer: When Harry Met Lloyd,
Kangaroo Jack,6934963,66934963,60000000,4.4,2003,Kangaroo Jack,
The Recruit,6802140,52802140,46000000,6.6,2003,The Recruit,
Dickie Roberts: Former Child Star,5738671,22738671,17000000,5.6,2003,Dickie Roberts: Former Child Star,
House of 1000 Corpses,5634962,12634962,7000000,6.1,2003,House of 1000 Corpses,
The Station Agent,5239376,5739376,500000,7.6,2003,The Station Agent,
The Cooler,5091572,8291572,3200000,6.9,2003,The Cooler,
Head of State,2925247,38125247,35200000,5.5,2003,Head of State,
Wrong Turn,2818790,15418790,12600000,6.1,2003,Wrong Turn,
Thirteen,2601043,4601043,2000000,6.8,2003,Thirteen,
Pieces of April,2228664,2528664,300000,7,2003,Pieces of April,
My Boss's Daughter,1550605,15550605,14000000,4.7,2003,My Boss's Daughter,
Saints and Soldiers,530470,1310470,780000,6.7,2003,Saints and Soldiers,
Latter Days,-15315,834685,850000,7,2003,Latter Days,
Girl with a Pearl Earring,-329029,11670971,12000000,6.9,2003,Girl with a Pearl Earring,
Grind,-876304,5123696,6000000,6,2003,Grind,
Mona Lisa Smile,-1139058,63860942,65000000,6.5,2003,Mona Lisa Smile,
Elephant,-1733045,1266955,3000000,7.2,2003,Elephant,
House of the Dead,-1750281,10249719,12000000,2,2003,House of the Dead,
Biker Boyz,-1923228,22076772,24000000,4.7,2003,Biker Boyz,
All the Real Girls,-1950334,549666,2500000,6.8,2003,All the Real Girls,
Confidence,-2748360,12251640,15000000,6.7,2003,Confidence,
Big Fish,-3190307,66809693,70000000,8,2003,Big Fish,
The Shape of Things,-3264008,735992,4000000,6.7,2003,The Shape of Things,
House of Sand and Fog,-3459712,13040288,16500000,7.5,2003,House of Sand and Fog,
21 Grams,-3709524,16290476,20000000,7.7,2003,21 Grams,
Shattered Glass,-3779992,2220008,6000000,7.1,2003,Shattered Glass,
Wonderland,-3939488,1060512,5000000,6.6,2003,Wonderland,
Party Monster,-4257102,742898,5000000,6.3,2003,Party Monster,
A Guy Thing,-4454569,15545431,20000000,5.6,2003,A Guy Thing,
Hulk,-4822766,132177234,137000000,5.6,2003,Hulk,
The Room,-5450398,549602,6000000,3.7,2003,The Room,
Paycheck,-6209549,53790451,60000000,6.3,2003,Paycheck,
From Justin to Kelly,-7071117,4928883,12000000,2.1,2003,From Justin to Kelly,
In the Cut,-7249398,4750602,12000000,5.3,2003,In the Cut,
The Cat in the Hat,-7850715,101149285,109000000,3.9,2003,The Cat in the Hat,
Out of Time,-8911155,41088845,50000000,6.5,2003,Out of Time,
A Man Apart,-9263902,26736098,36000000,6.1,2003,A Man Apart,
The Brown Bunny,-9633699,366301,10000000,5,2003,The Brown Bunny,
Shade,-9974968,25032,10000000,6.3,2003,Shade,
Runaway Jury,-10556372,49443628,60000000,7.1,2003,Runaway Jury,
The Matrix Revolutions,-10686052,139313948,150000000,6.8,2003,The Matrix Revolutions,
The League of Extraordinary Gentlemen,-11534796,66465204,78000000,5.8,2003,The League of Extraordinary Gentlemen,
Johnny English,-11917634,28082366,40000000,6.2,2003,Johnny English,
The Dreamers,-12467772,2532228,15000000,7.2,2003,The Dreamers,
Willard,-13113911,6886089,20000000,6.1,2003,Willard,
The Haunted Mansion,-14152734,75847266,90000000,5,2003,The Haunted Mansion,
View from the Top,-14386000,15614000,30000000,5.2,2003,View from the Top,
Down with Love,-14694749,20305251,35000000,6.3,2003,Down with Love,
Anything Else,-14787690,3212310,18000000,6.3,2003,Anything Else,
Veronica Guerin,-15428496,1571504,17000000,6.9,2003,Veronica Guerin,
Alex & Emma,-15781302,14218698,30000000,5.6,2003,Alex & Emma,
The Life of David Gale,-18044402,19955598,38000000,7.6,2003,The Life of David Gale,
The Medallion,-18780808,22219192,41000000,5.3,2003,The Medallion,
Charlie's Angels: Full Throttle,-19169889,100830111,120000000,4.9,2003,Charlie's Angels: Full Throttle,
The In-Laws,-19546569,20453431,40000000,5.8,2003,The In-Laws,
The Hunted,-20755903,34244097,55000000,6.1,2003,The Hunted,
Stuck on You,-21167259,33832741,55000000,5.7,2003,Stuck on You,
Basic,-23206689,26793311,50000000,6.5,2003,Basic,
Luther,-24208672,5791328,30000000,6.5,2003,Luther,
The Human Stain,-24618092,5381908,30000000,6.2,2003,The Human Stain,
Intolerable Cruelty,-24672372,35327628,60000000,6.2,2003,Intolerable Cruelty,
Matchstick Men,-25093540,36906460,62000000,7.3,2003,Matchstick Men,
Bulletproof Monk,-28641292,23358708,52000000,5.5,2003,Bulletproof Monk,
The Core,-28813104,31186896,60000000,5.5,2003,The Core,
The Last Samurai,-28872737,111127263,140000000,7.7,2003,The Last Samurai,
Lara Croft Tomb Raider: The Cradle of Life,-29339804,65660196,95000000,5.6,2003,Lara Croft Tomb Raider: The Cradle of Life,
Duplex,-30307865,9692135,40000000,5.9,2003,Duplex,
The Order,-30339194,7660806,38000000,5.2,2003,The Order,
Beyond Borders,-30569899,4430101,35000000,6.5,2003,Beyond Borders,
Tears of the Sun,-31265124,43734876,75000000,6.6,2003,Tears of the Sun,
The Missing,-32988820,27011180,60000000,6.5,2003,The Missing,
Sinbad: Legend of the Seven Seas,-33516548,26483452,60000000,6.7,2003,Sinbad: Legend of the Seven Seas,
Dreamcatcher,-34284564,33715436,68000000,5.5,2003,Dreamcatcher,
The Rundown,-37273658,47726342,85000000,6.7,2003,The Rundown,
Brother Bear,-42663723,85336277,128000000,6.8,2003,Brother Bear,
Gods and Generals,-43117066,12882934,56000000,6.4,2003,Gods and Generals,
Hollywood Homicide,-44059309,30940691,75000000,5.3,2003,Hollywood Homicide,
Gigli,-47912458,6087542,54000000,2.5,2003,Gigli,
Terminator 3: Rise of the Machines,-49628888,150371112,200000000,6.3,2003,Terminator 3: Rise of the Machines,
Peter Pan,-51537392,48462608,100000000,6.8,2003,Peter Pan,
Master and Commander: The Far Side of the World,-56072080,93927920,150000000,7.4,2003,Master and Commander: The Far Side of the World,
Looney Tunes: Back in Action,-59008636,20991364,80000000,5.7,2003,Looney Tunes: Back in Action,
Timeline,-60518057,19481943,80000000,5.7,2003,Timeline,
Shrek 2,291226247,441226247,150000000,7.2,2004,Shrek 2,
Meet the Fockers,199261160,279261160,80000000,6.3,2004,Meet the Fockers,
Spider-Man 2,173585825,373585825,200000000,7.3,2004,Spider-Man 2,
The Incredibles,169441092,261441092,92000000,8,2004,The Incredibles,
Harry Potter and the Prisoner of Azkaban,119975996,249975996,130000000,7.9,2004,Harry Potter and the Prisoner of Azkaban,
The Bourne Supremacy,101241941,176241941,75000000,7.7,2004,The Bourne Supremacy,
The Grudge,100359362,110359362,10000000,5.9,2004,The Grudge,
Dodgeball: A True Underdog Story,94326736,114326736,20000000,6.7,2004,Dodgeball: A True Underdog Story,
Shark Tale,85861908,160861908,75000000,6,2004,Shark Tale,
National Treasure,73008894,173008894,100000000,6.9,2004,National Treasure,
Million Dollar Baby,70492203,100492203,30000000,8.1,2004,Million Dollar Baby,
Mean Girls,69058055,86058055,17000000,7,2004,Mean Girls,
The Day After Tomorrow,61740799,186740799,125000000,6.4,2004,The Day After Tomorrow,
Anchorman: The Legend of Ron Burgundy,59288303,85288303,26000000,7.2,2004,Anchorman: The Legend of Ron Burgundy,
Sideways,55503593,71503593,16000000,7.5,2004,Sideways,
The SpongeBob SquarePants Movie,55417988,85417988,30000000,7.1,2004,The SpongeBob SquarePants Movie,
The Princess Diaries 2: Royal Engagement,55170481,95170481,40000000,5.8,2004,The Princess Diaries 2: Royal Engagement,
Saw,54800369,56000369,1200000,7.6,2004,Saw,
The Village,54197520,114197520,60000000,6.5,2004,The Village,
The Notebook,52001787,81001787,29000000,7.8,2004,The Notebook,
Crash,48080300,54580300,6500000,7.7,2004,Crash,
Along Came Polly,46097164,88097164,42000000,6,2004,Along Came Polly,
50 First Dates,45908074,120908074,75000000,6.8,2004,50 First Dates,
The Butterfly Effect,44938693,57938693,13000000,7.6,2004,The Butterfly Effect,
Napoleon Dynamite,44140956,44540956,400000,6.9,2004,Napoleon Dynamite,
Without a Paddle,39169327,58169327,19000000,5.9,2004,Without a Paddle,
Miracle,36378093,64378093,28000000,7.5,2004,Miracle,
Kill Bill: Vol. 2,36208183,66208183,30000000,8,2004,Kill Bill: Vol. 2,
Collateral,36005703,101005703,65000000,7.5,2004,Collateral,
Ray,35331600,75331600,40000000,7.7,2004,Ray,
Barbershop 2: Back in Business,35111277,65111277,30000000,5.7,2004,Barbershop 2: Back in Business,
White Chicks,33831760,70831760,37000000,5.6,2004,White Chicks,
Dawn of the Dead,33020957,59020957,26000000,7.3,2004,Dawn of the Dead,
A Cinderella Story,32438175,51438175,19000000,5.9,2004,A Cinderella Story,
You Got Served,32363810,40363810,8000000,3.9,2004,You Got Served,
Friday Night Lights,31255921,61255921,30000000,7.2,2004,Friday Night Lights,
Starsky & Hutch,28237754,88237754,60000000,6.1,2004,Starsky & Hutch,
Finding Neverland,26680613,51680613,25000000,7.7,2004,Finding Neverland,
Garfield,25369589,75369589,50000000,5,2004,Garfield,
The Forgotten,25133509,67133509,42000000,5.8,2004,The Forgotten,
"I, Robot",24801023,144801023,120000000,7.1,2004,"I, Robot",
Garden State,24282316,26782316,2500000,7.4,2004,Garden State,
The Polar Express,22224490,187224490,165000000,6.6,2004,The Polar Express,
Fat Albert,22116322,48116322,26000000,4.3,2004,Fat Albert,
AVP: Alien vs. Predator,20282231,80282231,60000000,5.6,2004,AVP: Alien vs. Predator,
13 Going on 30,20231747,57231747,37000000,6.2,2004,13 Going on 30,
In Good Company,19806659,45806659,26000000,6.4,2004,In Good Company,
Ladder 49,19541707,74541707,55000000,6.5,2004,Ladder 49,
The Terminal,17872883,77872883,60000000,7.4,2004,The Terminal,
Ocean's Twelve,15544280,125544280,110000000,6.5,2004,Ocean's Twelve,
Eternal Sunshine of the Spotless Mind,14400301,34400301,20000000,8.3,2004,Eternal Sunshine of the Spotless Mind,
Confessions of a Teenage Drama Queen,14331068,29331068,15000000,4.7,2004,Confessions of a Teenage Drama Queen,
Christmas with the Kranks,13780539,73780539,60000000,5.4,2004,Christmas with the Kranks,
Anacondas: The Hunt for the Blood Orchid,12238923,32238923,20000000,4.7,2004,Anacondas: The Hunt for the Blood Orchid,
Taxi,11879320,36879320,25000000,4.5,2004,Taxi,
Harold & Kumar Go to White Castle,9250550,18250550,9000000,7.1,2004,Harold & Kumar Go to White Castle,
Secret Window,8022900,48022900,40000000,6.6,2004,Secret Window,
Man on Fire,7911774,77911774,70000000,7.7,2004,Man on Fire,
Shall We Dance,7890460,57890460,50000000,6.1,2004,Shall We Dance,
Cellular,7003620,32003620,25000000,6.5,2004,Cellular,
Closer,6987757,33987757,27000000,7.2,2004,Closer,
Resident Evil: Apocalypse,6201453,51201453,45000000,6.2,2004,Resident Evil: Apocalypse,
The Prince & Me,6176497,28176497,22000000,5.9,2004,The Prince & Me,
Seed of Chucky,5083732,17083732,12000000,4.8,2004,Seed of Chucky,
The Ladykillers,4799191,39799191,35000000,6.2,2004,The Ladykillers,
Scooby-Doo 2: Monsters Unleashed,4216833,84216833,80000000,5.1,2004,Scooby-Doo 2: Monsters Unleashed,
Saved!,3940582,8940582,5000000,6.7,2004,Saved!,
Before Sunset,3120649,5820649,2700000,8,2004,Before Sunset,
The Punisher,810189,33810189,33000000,6.4,2004,The Punisher,
Team America: World Police,786074,32786074,32000000,7.2,2004,Team America: World Police,
Walking Tall,437717,46437717,46000000,6.3,2004,Walking Tall,
Primer,417760,424760,7000,6.9,2004,Primer,
Bridget Jones: The Edge of Reason,226215,40226215,40000000,6,2004,Bridget Jones: The Edge of Reason,
Mean Creek,103951,603951,500000,7.2,2004,Mean Creek,
Bride & Prejudice,-394408,6605592,7000000,6.1,2004,Bride & Prejudice,
Sleepover,-563610,9436390,10000000,5.4,2004,Sleepover,
Kinsey,-745021,10254979,11000000,7,2004,Kinsey,
De-Lovely,-1543367,13456633,15000000,6.6,2004,De-Lovely,
Soul Plane,-1809250,14190750,16000000,4.5,2004,Soul Plane,
Agent Cody Banks 2: Destination London,-2369841,23630159,26000000,4.6,2004,Agent Cody Banks 2: Destination London,
D.E.B.S.,-3402554,97446,3500000,5.3,2004,D.E.B.S.,
Club Dread,-3598292,5001708,8600000,5.7,2004,Club Dread,
The Door in the Floor,-3645376,3854624,7500000,6.6,2004,The Door in the Floor,
The Machinist,-3917285,1082715,5000000,7.7,2004,The Machinist,
Paparazzi,-4285766,15714234,20000000,5.8,2004,Paparazzi,
Raise Your Voice,-4588020,10411980,15000000,5.9,2004,Raise Your Voice,
Win a Date with Tad Hamilton!,-4928038,17071962,22000000,5.6,2004,Win a Date with Tad Hamilton!,
A Home at the End of the World,-5470128,1029872,6500000,6.7,2004,A Home at the End of the World,
Hellboy,-6376042,59623958,66000000,6.8,2004,Hellboy,
Vanity Fair,-6863524,16136476,23000000,6.2,2004,Vanity Fair,
I Heart Huckabees,-7214568,12785432,20000000,6.6,2004,I Heart Huckabees,
EuroTrip,-7228613,17771387,25000000,6.6,2004,EuroTrip,
The Aviator,-7389670,102610330,110000000,7.5,2004,The Aviator,
Ella Enchanted,-8081613,22918387,31000000,6.3,2004,Ella Enchanted,
Mr 3000,-8188813,21811187,30000000,5.5,2004,Mr 3000,
Jersey Girl,-9731843,25268157,35000000,6.2,2004,Jersey Girl,
Being Julia,-10260951,7739049,18000000,7,2004,Being Julia,
The Girl Next Door,-10410556,14589444,25000000,6.7,2004,The Girl Next Door,
Godsend,-10620249,14379751,25000000,4.8,2004,Godsend,
Superbabies: Baby Geniuses 2,-10780612,9219388,20000000,1.9,2004,Superbabies: Baby Geniuses 2,
Chasing Liberty,-10804374,12195626,23000000,6.1,2004,Chasing Liberty,
Dirty Dancing: Havana Nights,-10838410,14161590,25000000,6,2004,Dirty Dancing: Havana Nights,
Taking Lives,-12317658,32682342,45000000,6.3,2004,Taking Lives,
Raising Helen,-12513488,37486512,50000000,6,2004,Raising Helen,
Blade: Trinity,-12588094,52411906,65000000,5.9,2004,Blade: Trinity,
A Dirty Shame,-13660332,1339668,15000000,5.1,2004,A Dirty Shame,
Wimbledon,-13998867,17001133,31000000,6.3,2004,Wimbledon,
The Manchurian Candidate,-14044370,65955630,80000000,6.6,2004,The Manchurian Candidate,
Little Black Book,-14301332,20698668,35000000,5.3,2004,Little Black Book,
Spartan,-14815568,4434432,19250000,6.5,2004,Spartan,
Birth,-14904962,5095038,20000000,6.1,2004,Birth,
Welcome to Mooseport,-15529053,14470947,30000000,5.2,2004,Welcome to Mooseport,
New York Minute,-15928559,14071441,30000000,5,2004,New York Minute,
Beyond the Sea,-16681291,6318709,23000000,6.7,2004,Beyond the Sea,
Wicker Park,-16998743,13001257,30000000,7,2004,Wicker Park,
Suspect Zero,-18274187,8725813,27000000,5.8,2004,Suspect Zero,
Torque,-18784941,21215059,40000000,4.1,2004,Torque,
First Daughter,-20944079,9055921,30000000,5.1,2004,First Daughter,
A Series of Unfortunate Events,-21365451,118634549,140000000,6.8,2004,A Series of Unfortunate Events,
Mindhunters,-22519256,4480744,27000000,6.4,2004,Mindhunters,
The Whole Ten Yards,-23671529,16328471,40000000,5.5,2004,The Whole Ten Yards,
Flight of the Phoenix,-23990820,21009180,45000000,6.1,2004,Flight of the Phoenix,
Twisted,-24801402,25198598,50000000,5.3,2004,Twisted,
The Life Aquatic with Steve Zissou,-25979597,24020403,50000000,7.3,2004,The Life Aquatic with Steve Zissou,
The Merchant of Venice,-26234415,3765585,30000000,7,2004,The Merchant of Venice,
Envy,-26437675,13562325,40000000,4.8,2004,Envy,
The Perfect Score,-29608997,10391003,40000000,5.7,2004,The Perfect Score,
The Stepford Wives,-30515258,59484742,90000000,5.3,2004,The Stepford Wives,
After the Sunset,-31668767,28331233,60000000,6.3,2004,After the Sunset,
Sky Captain and the World of Tomorrow,-32237323,37762677,70000000,6,2004,Sky Captain and the World of Tomorrow,
Hidalgo,-32696550,67303450,100000000,6.7,2004,Hidalgo,
Surviving Christmas,-33336844,11663156,45000000,5.4,2004,Surviving Christmas,
Spanglish,-37273131,42726869,80000000,6.4,2004,Spanglish,
Exorcist: The Beginning,-38178014,41821986,80000000,5.2,2004,Exorcist: The Beginning,
Van Helsing,-39822916,120177084,160000000,6.1,2004,Van Helsing,
Troy,-41621744,133378256,175000000,7.2,2004,Troy,
The Big Bounce,-43510524,6489476,50000000,4.9,2004,The Big Bounce,
Alfie,-46600188,13399812,60000000,6.2,2004,Alfie,
The Chronicles of Riddick,-47238988,57761012,105000000,6.7,2004,The Chronicles of Riddick,
Thunderbirds,-50119083,6880917,57000000,4.3,2004,Thunderbirds,
Catwoman,-59797621,40202379,100000000,3.4,2004,Catwoman,
Home on the Range,-59969539,50030461,110000000,5.4,2004,Home on the Range,
King Arthur,-68117756,51882244,120000000,6.3,2004,King Arthur,
The Alamo,-84585039,22414961,107000000,6,2004,The Alamo,
Around the World in 80 Days,-85991863,24008137,110000000,5.9,2004,Around the World in 80 Days,
Alexander,-120702809,34297191,155000000,5.6,2004,Alexander,
Star Wars: Episode III - Revenge of the Sith,267270577,380270577,113000000,7.5,2005,Star Wars: Episode III - Revenge of the Sith,
Wedding Crashers,169255921,209255921,40000000,6.9,2005,Wedding Crashers,
Harry Potter and the Goblet of Fire,140417905,290417905,150000000,7.7,2005,Harry Potter and the Goblet of Fire,
"The Chronicles of Narnia: The Lion, the Witch and the Wardrobe",111710957,291710957,180000000,6.9,2005,"The Chronicles of Narnia: The Lion, the Witch and the Wardrobe",
Hitch,109495555,179495555,70000000,6.6,2005,Hitch,
War of the Worlds,102280354,234280354,132000000,6.5,2005,War of the Worlds,
Walk the Line,91519402,119519402,28000000,7.8,2005,Walk the Line,
The 40 Year Old Virgin,83449237,109449237,26000000,7.1,2005,The 40 Year Old Virgin,
Saw II,83039965,87039965,4000000,6.6,2005,Saw II,
Mr. & Mrs. Smith,76336279,186336279,110000000,6.5,2005,Mr. & Mrs. Smith,
The Longest Yard,76119460,158119460,82000000,6.4,2005,The Longest Yard,
Brokeback Mountain,69043761,83043761,14000000,7.7,2005,Brokeback Mountain,
The Pacifier,57086868,113086868,56000000,5.6,2005,The Pacifier,
Batman Begins,56852432,206852432,150000000,8.2,2005,Batman Begins,
Charlie and the Chocolate Factory,56459076,206459076,150000000,6.6,2005,Charlie and the Chocolate Factory,
The Exorcism of Emily Rose,56072454,75072454,19000000,6.7,2005,The Exorcism of Emily Rose,
Fantastic Four,54696080,154696080,100000000,5.7,2005,Fantastic Four,
Robots,53200012,128200012,75000000,6.3,2005,Robots,
Are We There Yet?,50674398,82674398,32000000,4.7,2005,Are We There Yet?,
White Noise,46386759,56386759,10000000,5.5,2005,White Noise,
The Amityville Horror,46233369,65233369,19000000,6,2005,The Amityville Horror,
Diary of a Mad Black Woman,45133099,50633099,5500000,5.8,2005,Diary of a Mad Black Woman,
Hostel,42526473,47326473,4800000,5.9,2005,Hostel,
The Family Stone,42062868,60062868,18000000,6.3,2005,The Family Stone,
Monster-in-Law,39931301,82931301,43000000,5.6,2005,Monster-in-Law,
Coach Carter,37264877,67264877,30000000,7.3,2005,Coach Carter,
Flightplan,34707299,89707299,55000000,6.3,2005,Flightplan,
Sin City,34103820,74103820,40000000,8,2005,Sin City,
Guess Who,33915888,68915888,35000000,5.9,2005,Guess Who,
Red Eye,31891803,57891803,26000000,6.4,2005,Red Eye,
Hoodwinked!,31530390,61530390,30000000,6.4,2005,Hoodwinked!,
The Dukes of Hazzard,30270227,80270227,50000000,5.1,2005,The Dukes of Hazzard,
Four Brothers,29494381,74494381,45000000,6.8,2005,Four Brothers,
Sky High,28946815,63946815,35000000,6.2,2005,Sky High,
Boogeyman,26752382,46752382,20000000,4.2,2005,Boogeyman,
The Ring Two,26231249,76231249,50000000,5.4,2005,The Ring Two,
The Curse of the Were-Rabbit,26110897,56110897,30000000,7.4,2005,The Curse of the Were-Rabbit,
"Good Night, and Good Luck.",24558003,31558003,7000000,7.4,2005,"Good Night, and Good Luck.",
Cheaper by the Dozen 2,22571173,82571173,60000000,5.5,2005,Cheaper by the Dozen 2,
Nanny McPhee,22144110,47144110,25000000,6.5,2005,Nanny McPhee,
Capote,21750530,28750530,7000000,7.3,2005,Capote,
Hide and Seek,21100486,51100486,30000000,6,2005,Hide and Seek,
Racing Stripes,19772522,49772522,30000000,5.2,2005,Racing Stripes,
Hustle & Flow,19402809,22202809,2800000,7.3,2005,Hustle & Flow,
Because of Winn-Dixie,18647042,32647042,14000000,6.3,2005,Because of Winn-Dixie,
Thank You for Smoking,18293509,24793509,6500000,7.6,2005,Thank You for Smoking,
The Wedding Date,16726995,31726995,15000000,6.2,2005,The Wedding Date,
V for Vendetta,16511035,70511035,54000000,8.2,2005,V for Vendetta,
Herbie Fully Loaded,16023816,66023816,50000000,4.8,2005,Herbie Fully Loaded,
The Sisterhood of the Traveling Pants,14053061,39053061,25000000,6.5,2005,The Sisterhood of the Traveling Pants,
Derailed,14024076,36024076,22000000,6.6,2005,Derailed,
Must Love Dogs,13894863,43894863,30000000,5.9,2005,Must Love Dogs,
Corpse Bride,13359111,53359111,40000000,7.3,2005,Corpse Bride,
Waiting...,13124543,16124543,3000000,6.8,2005,Waiting...,
Fever Pitch,12071069,42071069,30000000,6.2,2005,Fever Pitch,
The Fog,11550869,29550869,18000000,3.7,2005,The Fog,
Transporter 2,11095856,43095856,32000000,6.3,2005,Transporter 2,
King Kong,11080025,218080025,207000000,7.2,2005,King Kong,
Pride & Prejudice,10405088,38405088,28000000,7.8,2005,Pride & Prejudice,
Fun with Dick and Jane,10332737,110332737,100000000,6.2,2005,Fun with Dick and Jane,
The Devil's Rejects,10044981,17044981,7000000,6.8,2005,The Devil's Rejects,
Cry Wolf,9047674,10047674,1000000,5.8,2005,Cry Wolf,
The Constant Gardener,8579797,33579797,25000000,7.4,2005,The Constant Gardener,
"Yours, Mine & Ours",8412862,53412862,45000000,5.5,2005,"Yours, Mine & Ours",
Match Point,8151529,23151529,15000000,7.6,2005,Match Point,
Transamerica,8015303,9015303,1000000,7.4,2005,Transamerica,
Kicking & Screaming,7842724,52842724,45000000,5.6,2005,Kicking & Screaming,
The Upside of Anger,6761993,18761993,12000000,6.8,2005,The Upside of Anger,
The Perfect Man,6535005,16535005,10000000,5.5,2005,The Perfect Man,
The Squid and the Whale,5872734,7372734,1500000,7.3,2005,The Squid and the Whale,
Land of the Dead,5700082,20700082,15000000,6.2,2005,Land of the Dead,
The Skeleton Key,4907715,47907715,43000000,6.5,2005,The Skeleton Key,
Broken Flowers,3744960,13744960,10000000,7.2,2005,Broken Flowers,
Miss Congeniality 2: Armed & Fabulous,3478006,48478006,45000000,5.1,2005,Miss Congeniality 2: Armed & Fabulous,
Be Cool,3046979,56046979,53000000,5.6,2005,Be Cool,
An American Haunting,2298046,16298046,14000000,5.1,2005,An American Haunting,
Me and You and Everyone We Know,1885134,3885134,2000000,7.3,2005,Me and You and Everyone We Know,
Junebug,1678691,2678691,1000000,6.9,2005,Junebug,
Brick,1600743,2075743,475000,7.3,2005,Brick,
Keeping Mum,1450466,1619466,169000,6.8,2005,Keeping Mum,
Harsh Times,1337931,3337931,2000000,6.9,2005,Harsh Times,
The Hitchhiker's Guide to the Galaxy,1085416,51085416,50000000,6.8,2005,The Hitchhiker's Guide to the Galaxy,
Prime,827153,22827153,22000000,6.2,2005,Prime,
Syriana,824620,50824620,50000000,6.9,2005,Syriana,
Dreamer: Inspired by a True Story,751093,32751093,32000000,6.8,2005,Dreamer: Inspired by a True Story,
Deuce Bigalow: European Gigolo,400154,22400154,22000000,4.7,2005,Deuce Bigalow: European Gigolo,
The Matador,94698,12594698,12500000,6.7,2005,The Matador,
Hard Candy,74640,1024640,950000,7.1,2005,Hard Candy,
Conversations with Other Women,-70582,379418,450000,7,2005,Conversations with Other Women,
Factotum,-191779,808221,1000000,6.6,2005,Factotum,
A History of Violence,-495367,31504633,32000000,7.4,2005,A History of Violence,
The Quiet,-518580,381420,900000,6.2,2005,The Quiet,
The Ballad of Jack and Rose,-787725,712275,1500000,6.6,2005,The Ballad of Jack and Rose,
Bad News Bears,-2131651,32868349,35000000,5.8,2005,Bad News Bears,
Thumbsucker,-2671321,1328679,4000000,6.6,2005,Thumbsucker,
Mirrormask,-3133001,866999,4000000,6.8,2005,Mirrormask,
Feast,-3143869,56131,3200000,6.3,2005,Feast,
Dark Water,-4526648,25473352,30000000,5.6,2005,Dark Water,
Everything Is Illuminated,-5287663,1712337,7000000,7.4,2005,Everything Is Illuminated,
Goal!,-5716745,4283255,10000000,6.7,2005,Goal!,
The Chumscrubber,-6747403,52597,6800000,6.9,2005,The Chumscrubber,
The Ice Harvest,-6983218,9016782,16000000,6.3,2005,The Ice Harvest,
The Interpreter,-7291839,72708161,80000000,6.4,2005,The Interpreter,
Down in the Valley,-7431068,568932,8000000,6.4,2005,Down in the Valley,
House of Wax,-7935200,32064800,40000000,5.3,2005,House of Wax,
A Lot Like Love,-8154281,21845719,30000000,6.6,2005,A Lot Like Love,
Mrs Henderson Presents,-8963634,11036366,20000000,7,2005,Mrs Henderson Presents,
Get Rich or Die Tryin',-9014648,30985352,40000000,5.4,2005,Get Rich or Die Tryin',
Jarhead,-9341780,62658220,72000000,7,2005,Jarhead,
The Weather Man,-9517225,12482775,22000000,6.5,2005,The Weather Man,
Just Like Heaven,-9681870,48318130,58000000,6.7,2005,Just Like Heaven,
Edmond,-9868281,131719,10000000,6.2,2005,Edmond,
Assault on Precinct 13,-9959105,20040895,30000000,6.3,2005,Assault on Precinct 13,
The Three Burials of Melquiades Estrada,-9972316,5027684,15000000,7.4,2005,The Three Burials of Melquiades Estrada,
The Greatest Game Ever Played,-10662607,15337393,26000000,7.4,2005,The Greatest Game Ever Played,
Kiss Kiss Bang Bang,-10756244,4243756,15000000,7.5,2005,Kiss Kiss Bang Bang,
The Adventures of Sharkboy and Lavagirl 3-D,-10822316,39177684,50000000,3.5,2005,The Adventures of Sharkboy and Lavagirl 3-D,
Rent,-10922453,29077547,40000000,6.9,2005,Rent,
Two for the Money,-12008621,22991379,35000000,6.3,2005,Two for the Money,
Proof,-12464669,7535331,20000000,6.7,2005,Proof,
Serenity,-13485483,25514517,39000000,7.8,2005,Serenity,
Lords of Dogtown,-13726483,11273517,25000000,7.1,2005,Lords of Dogtown,
Manderlay,-14121622,78378,14200000,7.3,2005,Manderlay,
Chicken Little,-14613335,135386665,150000000,5.7,2005,Chicken Little,
Alone in the Dark,-14821431,5178569,20000000,2.4,2005,Alone in the Dark,
The Cave,-14992009,15007991,30000000,5.1,2005,The Cave,
Valiant,-15521894,19478106,35000000,5.5,2005,Valiant,
Rebound,-16290986,16809014,33100000,5.2,2005,Rebound,
North Country,-16662278,18337722,35000000,7.3,2005,North Country,
The New World,-17287907,12712093,30000000,6.7,2005,The New World,
Hostage,-17360061,34639939,52000000,6.6,2005,Hostage,
Elizabethtown,-18149574,26850426,45000000,6.4,2005,Elizabethtown,
Elektra,-18590278,24409722,43000000,4.7,2005,Elektra,
Cursed,-18702478,19297522,38000000,5,2005,Cursed,
The World's Fastest Indian,-19871876,5128124,25000000,7.8,2005,The World's Fastest Indian,
Man of the House,-20300294,19699706,40000000,5.4,2005,Man of the House,
Unleashed,-20462379,24537621,45000000,7,2005,Unleashed,
An Unfinished Life,-21413608,8586392,30000000,7,2005,An Unfinished Life,
Bewitched,-21686841,63313159,85000000,4.8,2005,Bewitched,
BloodRayne,-22594580,2405420,25000000,2.9,2005,BloodRayne,
Munich,-22596315,47403685,70000000,7.5,2005,Munich,
The Jacket,-22696238,6303762,29000000,7.1,2005,The Jacket,
Constantine,-24023822,75976178,100000000,7,2005,Constantine,
The Man,-24669280,8330720,33000000,5.6,2005,The Man,
The Producers,-25601468,19398532,45000000,6.3,2005,The Producers,
Lord of War,-25850368,24149632,50000000,7.6,2005,Lord of War,
Cinderella Man,-26350089,61649911,88000000,8,2005,Cinderella Man,
Rumor Has It...,-26999738,43000262,70000000,5.5,2005,Rumor Has It...,
Memoirs of a Geisha,-27509492,57490508,85000000,7.4,2005,Memoirs of a Geisha,
The Legend of Zorro,-28535977,46464023,75000000,6,2005,The Legend of Zorro,
Dominion: Prequel to the Exorcist,-29748505,251495,30000000,5.2,2005,Dominion: Prequel to the Exorcist,
Into the Blue,-31198766,18801234,50000000,5.9,2005,Into the Blue,
Doom,-31787663,28212337,60000000,5.2,2005,Doom,
Zathura: A Space Adventure,-35741131,29258869,65000000,6.2,2005,Zathura: A Space Adventure,
√Üon Flux,-36125663,25874337,62000000,5.5,2005,√Üon Flux,
Domino,-39830798,10169202,50000000,5.9,2005,Domino,
Stay,-46373117,3626883,50000000,6.8,2005,Stay,
The Brothers Grimm,-50083733,37916267,88000000,5.9,2005,The Brothers Grimm,
Sahara,-61328075,68671925,130000000,6,2005,Sahara,
Son of the Mask,-66981578,17018422,84000000,2.2,2005,Son of the Mask,
A Sound of Thunder,-78099549,1900451,80000000,4.2,2005,A Sound of Thunder,
Kingdom of Heaven,-82601587,47398413,130000000,7.2,2005,Kingdom of Heaven,
xXx: State of the Union,-86126068,26873932,113000000,4.4,2005,xXx: State of the Union,
The Island,-90181087,35818913,126000000,6.8,2005,The Island,
Stealth,-102883254,32116746,135000000,5.1,2005,Stealth,
Pirates of the Caribbean: Dead Man's Chest,198315812,423315812,225000000,7.3,2006,Pirates of the Caribbean: Dead Man's Chest,
300,145614939,210614939,65000000,7.6,2006,300,
Night at the Museum,140863268,250863268,110000000,6.4,2006,Night at the Museum,
Cars,124082982,244082982,120000000,7.1,2006,Cars,
Ice Age: The Meltdown,115330621,195330621,80000000,6.8,2006,Ice Age: The Meltdown,
Borat: Cultural Learnings of America for Make Benefit Glorious Nation of Kazakhstan,110505958,128505958,18000000,7.3,2006,Borat: Cultural Learnings of America for Make Benefit Glorious Nation of Kazakhstan,
The Pursuit of Happyness,108566459,163566459,55000000,8,2006,The Pursuit of Happyness,
Happy Feet,98000317,198000317,100000000,6.4,2006,Happy Feet,
The Da Vinci Code,92536138,217536138,125000000,6.6,2006,The Da Vinci Code,
The Devil Wears Prada,89740460,124740460,35000000,6.9,2006,The Devil Wears Prada,
Talladega Nights: The Ballad of Ricky Bobby,75713377,148213377,72500000,6.6,2006,Talladega Nights: The Ballad of Ricky Bobby,
Over the Hedge,75019340,155019340,80000000,6.7,2006,Over the Hedge,
The Santa Clause 3: The Escape Clause,72500122,84500122,12000000,4.7,2006,The Santa Clause 3: The Escape Clause,
Saw III,70238724,80238724,10000000,6.2,2006,Saw III,
The Break-Up,66703275,118703275,52000000,5.8,2006,The Break-Up,
Madea's Family Reunion,57318000,63318000,6000000,5.2,2006,Madea's Family Reunion,
Click,54855633,137355633,82500000,6.4,2006,Click,
Step Up,53328121,65328121,12000000,6.5,2006,Step Up,
Little Miss Sunshine,51891098,59891098,8000000,7.8,2006,Little Miss Sunshine,
Rocky Balboa,46270943,70270943,24000000,7.1,2006,Rocky Balboa,
Scary Movie 4,45710620,90710620,45000000,5.1,2006,Scary Movie 4,
Nacho Libre,45197993,80197993,35000000,5.8,2006,Nacho Libre,
Inside Man,43513495,88513495,45000000,7.6,2006,Inside Man,
The Departed,42384315,132384315,90000000,8.5,2006,The Departed,
Eight Below,41612565,81612565,40000000,7.3,2006,Eight Below,
Failure to Launch,38715192,88715192,50000000,5.6,2006,Failure to Launch,
Dreamgirls,33365956,103365956,70000000,6.5,2006,Dreamgirls,
When a Stranger Calls,32860214,47860214,15000000,5.1,2006,When a Stranger Calls,
Big Momma's House 2,30165972,70165972,40000000,4.7,2006,Big Momma's House 2,
The Omen,29607383,54607383,25000000,5.5,2006,The Omen,
Final Destination 3,29098051,54098051,25000000,5.8,2006,Final Destination 3,
Date Movie,28548426,48548426,20000000,2.8,2006,Date Movie,
The Benchwarmers,26843754,59843754,33000000,5.5,2006,The Benchwarmers,
The Hills Have Eyes,26778863,41778863,15000000,6.4,2006,The Hills Have Eyes,
X-Men: The Last Stand,24362462,234362462,210000000,6.7,2006,X-Men: The Last Stand,
The Texas Chainsaw Massacre: The Beginning,23517763,39517763,16000000,5.8,2006,The Texas Chainsaw Massacre: The Beginning,
The Illusionist,23368642,39868642,16500000,7.6,2006,The Illusionist,
John Tucker Must Die,23011711,41011711,18000000,5.8,2006,John Tucker Must Die,
RV,21726025,71726025,50000000,5.5,2006,RV,
Barnyard,21637803,72637803,51000000,5.5,2006,Barnyard,
"You, Me and Dupree",21628110,75628110,54000000,5.6,2006,"You, Me and Dupree",
Clerks II,19148068,24148068,5000000,7.3,2006,Clerks II,
The Grudge 2,19143839,39143839,20000000,5.1,2006,The Grudge 2,
Smokin' Aces,18787686,35787686,17000000,6.7,2006,Smokin' Aces,
Invincible,17806952,57806952,40000000,7.1,2006,Invincible,
Casino Royale,17445960,167445960,150000000,8,2006,Casino Royale,
Man of the Year,17327390,37327390,20000000,6.2,2006,Man of the Year,
United 93,16483450,31483450,15000000,7.5,2006,United 93,
Employee of the Month,16444855,28444855,12000000,5.5,2006,Employee of the Month,
Stay Alive,16086480,23086480,7000000,5.1,2006,Stay Alive,
Crank,15838408,27838408,12000000,6.9,2006,Crank,
She's the Man,13741133,33741133,20000000,6.3,2006,She's the Man,
Accepted,13323505,36323505,23000000,6.4,2006,Accepted,
The Prestige,13089891,53089891,40000000,8.5,2006,The Prestige,
The Lake House,12330111,52330111,40000000,6.8,2006,The Lake House,
Underworld: Evolution,12318875,62318875,50000000,6.7,2006,Underworld: Evolution,
Larry the Cable Guy: Health Inspector,11680099,15680099,4000000,3.3,2006,Larry the Cable Guy: Health Inspector,
The Shaggy Dog,11123569,61123569,50000000,4.4,2006,The Shaggy Dog,
Akeelah and the Bee,10848430,18848430,8000000,7.3,2006,Akeelah and the Bee,
Stranger Than Fiction,10660952,40660952,30000000,7.5,2006,Stranger Than Fiction,
A Prairie Home Companion,10342852,20342852,10000000,6.7,2006,A Prairie Home Companion,
Facing the Giants,10078331,10178331,100000,6.6,2006,Facing the Giants,
Babel,9302837,34302837,25000000,7.4,2006,Babel,
Gridiron Gang,8432823,38432823,30000000,6.9,2006,Gridiron Gang,
Curious George,8360760,58360760,50000000,6.5,2006,Curious George,
Black Christmas,7273581,16273581,9000000,4.6,2006,Black Christmas,
See No Evil,7032800,15032800,8000000,5.1,2006,See No Evil,
Friends with Money,6868437,13368437,6500000,5.7,2006,Friends with Money,
Aquamarine,6597342,18597342,12000000,5.3,2006,Aquamarine,
Scoop,6525717,10525717,4000000,6.7,2006,Scoop,
World Trade Center,5278893,70278893,65000000,5.9,2006,World Trade Center,
Bella,4770537,8070537,3300000,7.2,2006,Bella,
Take the Lead,4742066,34742066,30000000,6.6,2006,Take the Lead,
The Namesake,4069248,13569248,9500000,7.5,2006,The Namesake,
The Night Listener,3836393,7836393,4000000,5.9,2006,The Night Listener,
The Covenant,3380495,23380495,20000000,5.3,2006,The Covenant,
Bug,3025810,7025810,4000000,6.1,2006,Bug,
The Pink Panther,2226474,82226474,80000000,5.7,2006,The Pink Panther,
Half Nelson,1997938,2697938,700000,7.2,2006,Half Nelson,
Beerfest,1685184,19185184,17500000,6.3,2006,Beerfest,
ATL,1170563,21170563,20000000,6.1,2006,ATL,
Snakes on a Plane,1020814,34020814,33000000,5.4,2006,Snakes on a Plane,
Open Season,105259,85105259,85000000,6.1,2006,Open Season,
Shortbus,-14708,1985292,2000000,6.4,2006,Shortbus,
Pulse,-235564,20264436,20500000,4.8,2006,Pulse,
Wristcutters: A Love Story,-553835,446165,1000000,7.3,2006,Wristcutters: A Love Story,
The Marine,-1155216,18844784,20000000,4.7,2006,The Marine,
Firewall,-1248811,48751189,50000000,5.8,2006,Firewall,
Hatchet,-1324719,175281,1500000,5.7,2006,Hatchet,
Monster House,-1338990,73661010,75000000,6.6,2006,Monster House,
Sherrybaby,-1800824,199176,2000000,6.6,2006,Sherrybaby,
The Astronaut Farmer,-1996357,11003643,13000000,6.3,2006,The Astronaut Farmer,
Charlotte's Web,-2014292,82985708,85000000,6.3,2006,Charlotte's Web,
Bobby,-2757199,11242801,14000000,7,2006,Bobby,
Turistas,-2972238,7027762,10000000,5.4,2006,Turistas,
A Scanner Darkly,-3198384,5501616,8700000,7.1,2006,A Scanner Darkly,
Unknown,-3673597,26403,3700000,6.5,2006,Unknown,
Lucky Number Slevin,-4504534,22495466,27000000,7.7,2006,Lucky Number Slevin,
Rescue Dawn,-4509577,5490423,10000000,7.3,2006,Rescue Dawn,
Running with Scissors,-4977173,7022827,12000000,6.2,2006,Running with Scissors,
Penelope,-4988004,10011996,15000000,6.7,2006,Penelope,
Factory Girl,-5324759,1675241,7000000,6.5,2006,Factory Girl,
Little Man,-5354948,58645052,64000000,4.4,2006,Little Man,
Black Snake Moan,-5603130,9396870,15000000,6.9,2006,Black Snake Moan,
Peaceful Warrior,-6039586,3960414,10000000,7.3,2006,Peaceful Warrior,
For Your Consideration,-6450077,5549923,12000000,6.3,2006,For Your Consideration,
Last Holiday,-6600039,38399961,45000000,6.5,2006,Last Holiday,
Slither,-7197550,7802450,15000000,6.4,2006,Slither,
The Return,-7250149,7749851,15000000,4.7,2006,The Return,
My Super Ex-Girlfriend,-7469705,22530295,30000000,5.1,2006,My Super Ex-Girlfriend,
Running Scared,-8144863,6855137,15000000,7.4,2006,Running Scared,
Unaccompanied Minors,-8344776,16655224,25000000,5.3,2006,Unaccompanied Minors,
The Last Kiss,-8385210,11614790,20000000,6.4,2006,The Last Kiss,
Annapolis,-8872008,17127992,26000000,5.9,2006,Annapolis,
Catch and Release,-9460949,15539051,25000000,6,2006,Catch and Release,
American Dreamz,-9808170,7191830,17000000,5.4,2006,American Dreamz,
Copying Beethoven,-10615971,384029,11000000,6.8,2006,Copying Beethoven,
Just My Luck,-10673350,17326650,28000000,5.4,2006,Just My Luck,
Deja Vu,-10961384,64038616,75000000,7,2006,Deja Vu,
The Painted Veil,-11339513,8060487,19400000,7.5,2006,The Painted Veil,
Ultraviolet,-11464188,18535812,30000000,4.4,2006,Ultraviolet,
Tenacious D in The Pick of Destiny,-11665425,8334575,20000000,6.8,2006,Tenacious D in The Pick of Destiny,
Find Me Guilty,-11826357,1173643,13000000,7,2006,Find Me Guilty,
Infamous,-11848670,1151330,13000000,7,2006,Infamous,
Home of the Brave,-11948292,51708,12000000,5.6,2006,Home of the Brave,
Hollywoodland,-13573749,14426251,28000000,6.5,2006,Hollywoodland,
The Guardian,-14988268,55011732,70000000,6.9,2006,The Guardian,
16 Blocks,-15104859,36895141,52000000,6.6,2006,16 Blocks,
It's a Boy Girl Thing,-15499152,848,15500000,6.3,2006,It's a Boy Girl Thing,
Mission: Impossible III,-15970199,134029801,150000000,6.9,2006,Mission: Impossible III,
The Wicker Man,-16350873,23649127,40000000,3.7,2006,The Wicker Man,
Fur: An Imaginary Portrait of Diane Arbus,-16576798,223202,16800000,6.5,2006,Fur: An Imaginary Portrait of Diane Arbus,
Southland Tales,-16724620,275380,17000000,5.4,2006,Southland Tales,
School for Scoundrels,-17192431,17807569,35000000,5.9,2006,School for Scoundrels,
Seraphim Falls,-17581704,418296,18000000,6.7,2006,Seraphim Falls,
Lonely Hearts,-17811435,188565,18000000,6.4,2006,Lonely Hearts,
The Hoax,-17835005,7164995,25000000,6.7,2006,The Hoax,
DOA: Dead or Alive,-20519187,480813,21000000,4.8,2006,DOA: Dead or Alive,
Little Children,-20536981,5463019,26000000,7.5,2006,Little Children,
We Are Marshall,-21454636,43545364,65000000,7.1,2006,We Are Marshall,
The Holiday,-21775151,63224849,85000000,6.9,2006,The Holiday,
The Ant Bully,-21857465,28142535,50000000,5.8,2006,The Ant Bully,
The Fast and the Furious: Tokyo Drift,-22485585,62514415,85000000,6,2006,The Fast and the Furious: Tokyo Drift,
Zoom,-23010672,11989328,35000000,4.4,2006,Zoom,
The Sentinel,-23719303,36280697,60000000,6.1,2006,The Sentinel,
Marie Antoinette,-24037529,15962471,40000000,6.4,2006,Marie Antoinette,
The Fountain,-24855990,10144010,35000000,7.2,2006,The Fountain,
Eragon,-24969837,75030163,100000000,5.1,2006,Eragon,
Freedomland,-25152114,12512886,37665000,5.1,2006,Freedomland,
Miss Potter,-26994395,3005605,30000000,6.9,2006,Miss Potter,
The Black Dahlia,-27454920,22545080,50000000,5.6,2006,The Black Dahlia,
A Good Year,-27540700,7459300,35000000,7,2006,A Good Year,
Lady in the Water,-27714831,42285169,70000000,5.5,2006,Lady in the Water,
The Fall,-27733095,2266905,30000000,7.9,2006,The Fall,
The Good German,-30691304,1308696,32000000,6,2006,The Good German,
Garfield: A Tale of Two Kitties,-31573253,28426747,60000000,5,2006,Garfield: A Tale of Two Kitties,
Stormbreaker,-39322354,677646,40000000,5.1,2006,Stormbreaker,
Children of Men,-40447617,35552383,76000000,7.9,2006,Children of Men,
The Wild,-42615954,37384046,80000000,5.3,2006,The Wild,
Blood Diamond,-42622084,57377916,100000000,8,2006,Blood Diamond,
Flyboys,-46909370,13090630,60000000,6.5,2006,Flyboys,
All the King's Men,-47778542,7221458,55000000,6.2,2006,All the King's Men,
Goya's Ghosts,-48999374,1000626,50000000,6.9,2006,Goya's Ghosts,
The Good Shepherd,-50047165,59952835,110000000,6.7,2006,The Good Shepherd,
Flags of Our Fathers,-56397624,33602376,90000000,7,2006,Flags of Our Fathers,
Perfume: The Story of a Murderer,-57776707,2223293,60000000,7.5,2006,Perfume: The Story of a Murderer,
Basic Instinct 2,-64028664,5971336,70000000,4.3,2006,Basic Instinct 2,
Superman Returns,-69918808,200081192,270000000,6,2006,Superman Returns,
Arthur et les Minimoys,-70867237,15132763,86000000,6,2006,Arthur et les Minimoys,
Miami Vice,-71549530,63450470,135000000,6,2006,Miami Vice,
Flushed Away,-84334328,64665672,149000000,6.6,2006,Flushed Away,
Poseidon,-99325183,60674817,160000000,5.7,2006,Poseidon,
Transformers,169246193,319246193,150000000,7,2007,Transformers,
Shrek the Third,162719944,322719944,160000000,6.1,2007,Shrek the Third,
Alvin and the Chipmunks,157326974,217326974,60000000,5.2,2007,Alvin and the Chipmunks,
Harry Potter and the Order of the Phoenix,142353413,292353413,150000000,7.5,2007,Harry Potter and the Order of the Phoenix,
Juno,135995265,143495265,7500000,7.4,2007,Juno,
Knocked Up,118768917,148768917,30000000,6.9,2007,Knocked Up,
The Bourne Ultimatum,117471070,227471070,110000000,8,2007,The Bourne Ultimatum,
The Simpsons Movie,108135014,183135014,75000000,7.3,2007,The Simpsons Movie,
Paranormal Activity,107903810,107918810,15000,6.3,2007,Paranormal Activity,
I Am Legend,106393010,256393010,150000000,7.2,2007,I Am Legend,
Superbad,101463226,121463226,20000000,7.6,2007,Superbad,
National Treasure: Book of Secrets,89964115,219964115,130000000,6.5,2007,National Treasure: Book of Secrets,
Spider-Man 3,78530303,336530303,258000000,6.2,2007,Spider-Man 3,
The Game Plan,68648202,90648202,22000000,6.1,2007,The Game Plan,
Bridge to Terabithia,65272442,82272442,17000000,7.1,2007,Bridge to Terabithia,
Disturbia,60209692,80209692,20000000,6.8,2007,Disturbia,
Blades of Glory,57594548,118594548,61000000,6.3,2007,Blades of Glory,
Ratatouille,56445654,206445654,150000000,8,2007,Ratatouille,
Saw IV,53300095,63300095,10000000,5.9,2007,Saw IV,
No Country for Old Men,49283625,74283625,25000000,8.1,2007,No Country for Old Men,
The Bucket List,48466502,93466502,45000000,7.4,2007,The Bucket List,
Stomp the Yard,48356221,61356221,13000000,5.4,2007,Stomp the Yard,
1408,46985628,71985628,25000000,6.8,2007,1408,
Hairspray,43871849,118871849,75000000,6.6,2007,Hairspray,
Halloween,43272029,58272029,15000000,6.1,2007,Halloween,
Enchanted,42807262,127807262,85000000,7,2007,Enchanted,
Why Did I Get Married?,40204525,55204525,15000000,5.9,2007,Why Did I Get Married?,
Norbit,35673607,95673607,60000000,4.1,2007,Norbit,
I Now Pronounce You Chuck & Larry,35059556,120059556,85000000,5.9,2007,I Now Pronounce You Chuck & Larry,
Ocean's Thirteen,32154724,117154724,85000000,6.9,2007,Ocean's Thirteen,
American Gangster,30164645,130164645,100000000,7.8,2007,American Gangster,
Premonition,27852604,47852604,20000000,5.9,2007,Premonition,
Live Free or Die Hard,24529403,134529403,110000000,7.1,2007,Live Free or Die Hard,
Michael Clayton,24033882,49033882,25000000,7.2,2007,Michael Clayton,
P.S. I Love You,23695808,53695808,30000000,7,2007,P.S. I Love You,
Dan in Real Life,22642963,47642963,25000000,6.7,2007,Dan in Real Life,
Are We Done Yet?,21662533,49662533,28000000,4.2,2007,Are We Done Yet?,
Atonement,20927067,50927067,30000000,7.8,2007,Atonement,
TMNT,20149098,54149098,34000000,6.2,2007,TMNT,
Epic Movie,19739367,39739367,20000000,2.4,2007,Epic Movie,
The Messengers,19374833,35374833,16000000,5.4,2007,The Messengers,
Waitress,17574800,19074800,1500000,7,2007,Waitress,
Hitman,15687694,39687694,24000000,6.3,2007,Hitman,
Freedom Writers,15605602,36605602,21000000,7.5,2007,Freedom Writers,
The Great Debaters,15236407,30236407,15000000,7.5,2007,The Great Debaters,
There Will Be Blood,15222514,40222514,25000000,8.2,2007,There Will Be Blood,
No Reservations,15107979,43107979,28000000,6.3,2007,No Reservations,
Music and Lyrics,10572589,50572589,40000000,6.5,2007,Music and Lyrics,
Reno 911!: Miami,10342161,20342161,10000000,5.9,2007,Reno 911!: Miami,
Good Luck Chuck,10017297,35017297,25000000,5.6,2007,Good Luck Chuck,
30 Days of Night,9569000,39569000,30000000,6.6,2007,30 Days of Night,
Pirates of the Caribbean: At World's End,9420425,309420425,300000000,7.1,2007,Pirates of the Caribbean: At World's End,
License to Wed,8799818,43799818,35000000,5.3,2007,License to Wed,
Mr. Brooks,8549298,28549298,20000000,7.3,2007,Mr. Brooks,
Mr. Bean's Holiday,8302167,33302167,25000000,6.4,2007,Mr. Bean's Holiday,
The Mist,7594957,25594957,18000000,7.1,2007,The Mist,
We Own the Night,7563179,28563179,21000000,6.8,2007,We Own the Night,
Hostel: Part II,7409452,17609452,10200000,5.5,2007,Hostel: Part II,
Daddy Day Camp,7235267,13235267,6000000,3.1,2007,Daddy Day Camp,
The Hitcher,6472961,16472961,10000000,5.6,2007,The Hitcher,
The Nanny Diaries,5930652,25930652,20000000,6.2,2007,The Nanny Diaries,
The Hills Have Eyes II,5804166,20804166,15000000,5.1,2007,The Hills Have Eyes II,
Ghost Rider,5802596,115802596,110000000,5.2,2007,Ghost Rider,
Awake,5777198,14377198,8600000,6.5,2007,Awake,
Resident Evil: Extinction,5648679,50648679,45000000,6.3,2007,Resident Evil: Extinction,
Nancy Drew,5612520,25612520,20000000,5.9,2007,Nancy Drew,
The Visitor,5427089,9427089,4000000,7.6,2007,The Visitor,
The Number 23,5193167,35193167,30000000,6.4,2007,The Number 23,
Aqua Teen Hunger Force Colon Movie Film for Theaters,4770368,5520368,750000,6.7,2007,Aqua Teen Hunger Force Colon Movie Film for Theaters,
Mr. Woodcock,3799486,25799486,22000000,5.1,2007,Mr. Woodcock,
Into the Wild,3354356,18354356,15000000,8.1,2007,Into the Wild,
Sweeney Todd: The Demon Barber of Fleet Street,2898073,52898073,50000000,7.3,2007,Sweeney Todd: The Demon Barber of Fleet Street,
4: Rise of the Silver Surfer,1921738,131921738,130000000,5.6,2007,4: Rise of the Silver Surfer,
AVPR: Aliens vs Predator - Requiem,1797066,41797066,40000000,4.7,2007,AVPR: Aliens vs Predator - Requiem,
August Rush,1664162,31664162,30000000,7.5,2007,August Rush,
I Think I Love My Wife,1550605,12550605,11000000,5.5,2007,I Think I Love My Wife,
Gone Baby Gone,1292962,20292962,19000000,7.6,2007,Gone Baby Gone,
In the Land of Women,1052958,11052958,10000000,6.4,2007,In the Land of Women,
Vacancy,363565,19363565,19000000,6.2,2007,Vacancy,
The Signal,201150,251150,50000,6,2007,The Signal,
Rush Hour 3,125968,140125968,140000000,6.2,2007,Rush Hour 3,
Reign Over Me,-338013,19661987,20000000,7.4,2007,Reign Over Me,
Death at a Funeral,-419572,8580428,9000000,7.4,2007,Death at a Funeral,
He Was a Quiet Man,-597569,2431,600000,6.8,2007,He Was a Quiet Man,
Georgia Rule,-896928,19103072,20000000,5.8,2007,Georgia Rule,
Diary of the Dead,-1041039,958961,2000000,5.6,2007,Diary of the Dead,
Who's Your Caddy?,-1286575,5713425,7000000,2.2,2007,Who's Your Caddy?,
My Name Is Bruce,-1326934,173066,1500000,6.2,2007,My Name Is Bruce,
3:10 to Yuma,-1393084,53606916,55000000,7.7,2007,3:10 to Yuma,
You Kill Me,-1570633,2429367,4000000,6.5,2007,You Kill Me,
Paranoid Park,-2513233,486767,3000000,6.7,2007,Paranoid Park,
War,-2513591,22486409,25000000,6.2,2007,War,
Dead Silence,-3190924,16809076,20000000,6.2,2007,Dead Silence,
December Boys,-3949285,50715,4000000,6.5,2007,December Boys,
Run Fatboy Run,-3996738,6003262,10000000,6.6,2007,Run Fatboy Run,
P2,-4004982,3995018,8000000,5.9,2007,P2,
The Darjeeling Limited,-4097285,11902715,16000000,7.2,2007,The Darjeeling Limited,
Savage Grace,-4164254,435746,4600000,5.8,2007,Savage Grace,
The Ten,-4480274,769726,5250000,5,2007,The Ten,
I Know Who Killed Me,-4501284,7498716,12000000,3.6,2007,I Know Who Killed Me,
Sydney White,-4607585,11892415,16500000,6.2,2007,Sydney White,
Youth Without Youth,-4755603,244397,5000000,6.2,2007,Youth Without Youth,
Redacted,-4934612,65388,5000000,6.1,2007,Redacted,
Sex and Death 101,-4976376,23624,5000000,6,2007,Sex and Death 101,
Rocket Science,-5285057,714943,6000000,6.6,2007,Rocket Science,
Wind Chill,-5963196,36804,6000000,5.8,2007,Wind Chill,
Lars and the Real Girl,-6027116,5972884,12000000,7.3,2007,Lars and the Real Girl,
The Comebacks,-6650073,13349927,20000000,4.3,2007,The Comebacks,
A Mighty Heart,-6823213,9176787,16000000,6.6,2007,A Mighty Heart,
Battle in Seattle,-7775831,224169,8000000,6.7,2007,Battle in Seattle,
Margot at the Wedding,-8040580,1959420,10000000,6,2007,Margot at the Wedding,
Charlie Bartlett,-8048301,3951699,12000000,7,2007,Charlie Bartlett,
Charlie Wilson's War,-8338905,66661095,75000000,7,2007,Charlie Wilson's War,
The Brothers Solomon,-9099074,900926,10000000,5.3,2007,The Brothers Solomon,
My Blueberry Nights,-9132725,867275,10000000,6.6,2007,My Blueberry Nights,
The Invisible,-9421091,20578909,30000000,6.2,2007,The Invisible,
King of California,-9731539,268461,10000000,6.6,2007,King of California,
Resurrecting the Champ,-9827427,3172573,13000000,6.7,2007,Resurrecting the Champ,
The Air I Breathe,-9974225,25775,10000000,6.8,2007,The Air I Breathe,
Bratz,-9989791,10010209,20000000,3.1,2007,Bratz,
Death Sentence,-10465742,9534258,20000000,6.8,2007,Death Sentence,
Reservation Road,-10878006,121994,11000000,6.7,2007,Reservation Road,
Before the Devil Knows You're Dead,-10915773,7084227,18000000,7.3,2007,Before the Devil Knows You're Dead,
The Lookout,-11399415,4600585,16000000,7,2007,The Lookout,
Blood and Chocolate,-11473153,3526847,15000000,5.4,2007,Blood and Chocolate,
Trade,-11785693,214307,12000000,7.4,2007,Trade,
Code Name: The Cleaner,-11864976,8135024,20000000,4.6,2007,Code Name: The Cleaner,
The Life Before Her Eyes,-12696561,303439,13000000,6.3,2007,The Life Before Her Eyes,
Things We Lost in the Fire,-12712685,3287315,16000000,7.2,2007,Things We Lost in the Fire,
88 Minutes,-12786533,17213467,30000000,5.9,2007,88 Minutes,
Funny Games,-13705081,1294919,15000000,6.6,2007,Funny Games,
Shooter,-13996418,47003582,61000000,7.2,2007,Shooter,
Captivity,-14373200,2626800,17000000,4.7,2007,Captivity,
The Reaping,-14873786,25126214,40000000,5.6,2007,The Reaping,
I'm Not There,-15982391,4017609,20000000,6.9,2007,I'm Not There,
Walk Hard: The Dewey Cox Story,-16682849,18317151,35000000,6.8,2007,Walk Hard: The Dewey Cox Story,
Rendition,-17763955,9736045,27500000,6.8,2007,Rendition,
Silk,-18896925,1103075,20000000,5.9,2007,Silk,
Martian Child,-19499690,7500310,27000000,6.8,2007,Martian Child,
Lions for Lambs,-19997146,15002854,35000000,6.2,2007,Lions for Lambs,
Across the Universe,-20397709,24602291,45000000,7.3,2007,Across the Universe,
Hannibal Rising,-22329014,27670986,50000000,6.2,2007,Hannibal Rising,
The Kingdom,-22463222,47536778,70000000,7,2007,The Kingdom,
The Heartbreak Kid,-23212743,36787257,60000000,5.8,2007,The Heartbreak Kid,
Bee Movie,-23368723,126631277,150000000,6.1,2007,Bee Movie,
The Hunting Party,-24030131,969869,25000000,6.8,2007,The Hunting Party,
The Assassination of Jesse James by the Coward Robert Ford,-26090851,3909149,30000000,7.5,2007,The Assassination of Jesse James by the Coward Robert Ford,
Shoot 'Em Up,-26192861,12807139,39000000,6.7,2007,Shoot 'Em Up,
Fred Claus,-27993223,72006777,100000000,5.6,2007,Fred Claus,
Stardust,-31365062,38634938,70000000,7.6,2007,Stardust,
Zodiac,-31919916,33080084,65000000,7.7,2007,Zodiac,
Mr. Magorium's Wonder Emporium,-32938445,32061555,65000000,6.2,2007,Mr. Magorium's Wonder Emporium,
The Brave One,-33206196,36793804,70000000,6.7,2007,The Brave One,
Pathfinder,-34767919,10232081,45000000,5.4,2007,Pathfinder,
The Seeker: The Dark Is Rising,-36205548,8794452,45000000,4.8,2007,The Seeker: The Dark Is Rising,
Perfect Stranger,-36810051,23984949,60795000,5.7,2007,Perfect Stranger,
Elizabeth: The Golden Age,-38616491,16383509,55000000,6.8,2007,Elizabeth: The Golden Age,
Love in the Time of Cholera,-40392392,4607608,45000000,6.4,2007,Love in the Time of Cholera,
Surf's Up,-41132306,58867694,100000000,6.7,2007,Surf's Up,
Grindhouse,-41962103,25037897,67000000,7.5,2007,Grindhouse,
Lucky You,-49241050,5758950,55000000,5.9,2007,Lucky You,
Next,-51788987,18211013,70000000,6.2,2007,Next,
Meet the Robinsons,-52177829,97822171,150000000,6.8,2007,Meet the Robinsons,
In the Name of the King: A Dungeon Siege Tale,-55224344,4775656,60000000,3.8,2007,In the Name of the King: A Dungeon Siege Tale,
The Invasion,-64925809,15074191,80000000,5.9,2007,The Invasion,
Beowulf,-67719421,82280579,150000000,6.2,2007,Beowulf,
Evan Almighty,-74537702,100462298,175000000,5.4,2007,Evan Almighty,
The Golden Compass,-109892272,70107728,180000000,6.1,2007,The Golden Compass,
The Dark Knight,350234033,535234033,185000000,9,2008,The Dark Knight,
Iron Man,179034126,319034126,140000000,7.9,2008,Iron Man,
Twilight,156962473,193962473,37000000,5.2,2008,Twilight,
Indiana Jones and the Kingdom of the Crystal Skull,132101119,317101119,185000000,6.1,2008,Indiana Jones and the Kingdom of the Crystal Skull,
Slumdog Millionaire,126319928,141319928,15000000,8,2008,Slumdog Millionaire,
Taken,120000989,145000989,25000000,7.8,2008,Taken,
Gran Torino,115095302,148095302,33000000,8.1,2008,Gran Torino,
Mamma Mia!,92169664,144169664,52000000,6.4,2008,Mamma Mia!,
Sex and the City,87647258,152647258,65000000,5.6,2008,Sex and the City,
Kung Fu Panda,85434591,215434591,130000000,7.5,2008,Kung Fu Panda,
Marley & Me,83153751,143153751,60000000,7.1,2008,Marley & Me,
High School Musical 3: Senior Year,79559416,90559416,11000000,4.8,2008,High School Musical 3: Senior Year,
Hancock,77946274,227946274,150000000,6.4,2008,Hancock,
Beverly Hills Chihuahua,74514402,94514402,20000000,3.8,2008,Beverly Hills Chihuahua,
Horton Hears a Who!,69529439,154529439,85000000,6.8,2008,Horton Hears a Who!,
Pineapple Express,60341380,87341380,27000000,6.9,2008,Pineapple Express,
Wanted,59508551,134508551,75000000,6.7,2008,Wanted,
Cloverfield,55048433,80048433,25000000,7,2008,Cloverfield,
Get Smart,50319208,130319208,80000000,6.5,2008,Get Smart,
27 Dresses,46808654,76808654,30000000,6.1,2008,27 Dresses,
21,46159365,81159365,35000000,6.8,2008,21,
Saw V,45946769,56746769,10800000,5.8,2008,Saw V,
What Happens in Vegas,45277646,80277646,35000000,6.1,2008,What Happens in Vegas,
WALL¬∑E,43808164,223808164,180000000,8.4,2008,WALL¬∑E,
The Strangers,43597610,52597610,9000000,6.2,2008,The Strangers,
Journey to the Center of the Earth,41704370,101704370,60000000,5.8,2008,Journey to the Center of the Earth,
Step Up 2: The Streets,40517783,58017783,17500000,6.2,2008,Step Up 2: The Streets,
Four Christmases,40146040,120146040,80000000,5.7,2008,Four Christmases,
Role Models,39294270,67294270,28000000,6.8,2008,Role Models,
Step Brothers,35468793,100468793,65000000,6.9,2008,Step Brothers,
Forgetting Sarah Marshall,33172463,63172463,30000000,7.1,2008,Forgetting Sarah Marshall,
Fireproof,32956317,33456317,500000,6.5,2008,Fireproof,
Vantage Point,32266306,72266306,40000000,6.6,2008,Vantage Point,
Baby Mama,30494212,60494212,30000000,6,2008,Baby Mama,
Bedtime Stories,30101975,110101975,80000000,6,2008,Bedtime Stories,
Madagascar: Escape 2 Africa,30010950,180010950,150000000,6.6,2008,Madagascar: Escape 2 Africa,
Yes Man,27690976,97690976,70000000,6.8,2008,Yes Man,
The Secret Life of Bees,26770162,37770162,11000000,7.3,2008,The Secret Life of Bees,
Star Wars: The Clone Wars,26661554,35161554,8500000,5.9,2008,Star Wars: The Clone Wars,
Harold & Kumar Escape from Guantanamo Bay,26108728,38108728,12000000,6.6,2008,Harold & Kumar Escape from Guantanamo Bay,
Prom Night,23869350,43869350,20000000,3.9,2008,Prom Night,
Burn After Reading,23355347,60355347,37000000,7,2008,Burn After Reading,
The House Bunny,23237389,48237389,25000000,5.5,2008,The House Bunny,
Nick and Norah's Infinite Playlist,21487293,31487293,10000000,6.6,2008,Nick and Norah's Infinite Playlist,
Eagle Eye,21440743,101440743,80000000,6.6,2008,Eagle Eye,
The Wrestler,20238243,26238243,6000000,7.9,2008,The Wrestler,
Quarantine,19691811,31691811,12000000,5.9,2008,Quarantine,
The Eye,19418697,31418697,12000000,5.4,2008,The Eye,
Lakeview Terrace,19263506,39263506,20000000,6.1,2008,Lakeview Terrace,
Tropic Thunder,18515313,110515313,92000000,7,2008,Tropic Thunder,
Shutter,17928550,25928550,8000000,5.2,2008,Shutter,
The Sisterhood of the Traveling Pants 2,17089964,44089964,27000000,6.2,2008,The Sisterhood of the Traveling Pants 2,
The Happening,16506874,64506874,48000000,5,2008,The Happening,
Seven Pounds,14951824,69951824,55000000,7.6,2008,Seven Pounds,
Doubt,13446470,33446470,20000000,7.5,2008,Doubt,
Nights in Rodanthe,11850659,41850659,30000000,6,2008,Nights in Rodanthe,
Milk,11841299,31841299,20000000,7.5,2008,Milk,
Nim's Island,11006762,48006762,37000000,6,2008,Nim's Island,
The Women,10902075,26902075,16000000,5,2008,The Women,
The Bank Job,10060660,30060660,20000000,7.2,2008,The Bank Job,
You Don't Mess with the Zohan,10018837,100018837,90000000,5.5,2008,You Don't Mess with the Zohan,
The Ruins,9432844,17432844,8000000,5.8,2008,The Ruins,
Meet the Spartans,8233676,38233676,30000000,2.8,2008,Meet the Spartans,
Valkyrie,8077833,83077833,75000000,7.1,2008,Valkyrie,
Vicky Cristina Barcelona,7716709,23216709,15500000,7.1,2008,Vicky Cristina Barcelona,
Zack and Miri Make a Porno,7457946,31457946,24000000,6.5,2008,Zack and Miri Make a Porno,
"Welcome Home, Roscoe Jenkins",7436517,42436517,35000000,5.5,2008,"Welcome Home, Roscoe Jenkins",
One Missed Call,6890041,26890041,20000000,4,2008,One Missed Call,
Street Kings,6418667,26418667,20000000,6.8,2008,Street Kings,
Made of Honor,6012734,46012734,40000000,5.9,2008,Made of Honor,
Max Payne,5689393,40689393,35000000,5.4,2008,Max Payne,
Never Back Down,4850922,24850922,20000000,6.6,2008,Never Back Down,
Sunshine Cleaning,4062558,12062558,8000000,6.8,2008,Sunshine Cleaning,
The Reader,2194407,34194407,32000000,7.6,2008,The Reader,
The Hurt Locker,2017811,17017811,15000000,7.6,2008,The Hurt Locker,
Transporter 3,1715062,31715062,30000000,6.1,2008,Transporter 3,
Traitor,1530831,23530831,22000000,7,2008,Traitor,
Frozen River,1511476,2511476,1000000,7.1,2008,Frozen River,
Wendy and Lucy,665695,865695,200000,7.1,2008,Wendy and Lucy,
W.,434493,25534493,25100000,6.3,2008,W.,
Fool's Gold,231041,70231041,70000000,5.7,2008,Fool's Gold,
Appaloosa,211394,20211394,20000000,6.7,2008,Appaloosa,
Choke,-73435,2926565,3000000,6.4,2008,Choke,
Bronson,-125021,104979,230000,7.1,2008,Bronson,
The Day the Earth Stood Still,-633022,79366978,80000000,5.5,2008,The Day the Earth Stood Still,
I Sell the Dead,-741950,8050,750000,6.1,2008,I Sell the Dead,
My Best Friend's Girl,-780750,19219250,20000000,5.9,2008,My Best Friend's Girl,
Bottle Shock,-921393,4078607,5000000,6.8,2008,Bottle Shock,
Lymelife,-1078693,421307,1500000,6.9,2008,Lymelife,
Mad Money,-1331157,20668843,22000000,5.8,2008,Mad Money,
College,-2305364,4694636,7000000,4.6,2008,College,
Over Her Dead Body,-2436330,7563670,10000000,5.2,2008,Over Her Dead Body,
RED,-2495357,4643,2500000,7,2008,RED,
The Forbidden Kingdom,-2924730,52075270,55000000,6.6,2008,The Forbidden Kingdom,
Defiance,-3355187,28644813,32000000,7.2,2008,Defiance,
The Boy in the Striped Pyjamas,-3453844,9046156,12500000,7.8,2008,The Boy in the Striped Pyjamas,
Surveillance,-3472651,27349,3500000,6.3,2008,Surveillance,
Cadillac Records,-3804449,8195551,12000000,7,2008,Cadillac Records,
The Wackness,-3922884,2077116,6000000,7,2008,The Wackness,
Hamlet 2,-4113784,4886216,9000000,6.3,2008,Hamlet 2,
Mirrors,-4308561,30691439,35000000,6.2,2008,Mirrors,
Redbelt,-4654059,2345941,7000000,6.7,2008,Redbelt,
Swing Vote,-4710133,16289867,21000000,6.1,2008,Swing Vote,
Jumper,-4827872,80172128,85000000,6.1,2008,Jumper,
Igor,-5471398,19528602,25000000,6,2008,Igor,
Disaster Movie,-5809099,14190901,20000000,1.9,2008,Disaster Movie,
Untraceable,-6312165,28687835,35000000,6.2,2008,Untraceable,
Frost/Nixon,-6377969,18622031,25000000,7.7,2008,Frost/Nixon,
Ghost Town,-6632376,13367624,20000000,6.7,2008,Ghost Town,
Two Lovers,-6650966,3149034,9800000,7,2008,Two Lovers,
Space Chimps,-6894032,30105968,37000000,4.5,2008,Space Chimps,
Drillbit Taylor,-7137896,32862104,40000000,5.7,2008,Drillbit Taylor,
In Bruges,-7199176,7800824,15000000,7.9,2008,In Bruges,
Rambo,-7245895,42754105,50000000,7,2008,Rambo,
The Promotion,-7591291,408709,8000000,5.6,2008,The Promotion,
Pathology,-7890154,109846,8000000,6,2008,Pathology,
Fireflies in the Garden,-7929400,70600,8000000,6.5,2008,Fireflies in the Garden,
The Other Boleyn Girl,-8185043,26814957,35000000,6.7,2008,The Other Boleyn Girl,
Repo! The Genetic Opera,-8353250,146750,8500000,6.6,2008,Repo! The Genetic Opera,
The Rocker,-8590472,6409528,15000000,6.2,2008,The Rocker,
Death Race,-8683968,36316032,45000000,6.4,2008,Death Race,
Be Kind Rewind,-8824836,11175164,20000000,6.4,2008,Be Kind Rewind,
Hellboy II: The Golden Army,-9013497,75986503,85000000,7,2008,Hellboy II: The Golden Army,
The X Files: I Want to Believe,-9017522,20982478,30000000,5.9,2008,The X Files: I Want to Believe,
Superhero Movie,-9118932,25881068,35000000,4.5,2008,Superhero Movie,
The Tale of Despereaux,-9122855,50877145,60000000,6.1,2008,The Tale of Despereaux,
Elegy,-9418358,3581642,13000000,6.7,2008,Elegy,
"War, Inc.",-9419138,580862,10000000,5.6,2008,"War, Inc.",
"10,000 BC",-10215799,94784201,105000000,5.1,2008,"10,000 BC",
Sex Drive,-10597515,8402485,19000000,6.5,2008,Sex Drive,
Revolutionary Road,-12088520,22911480,35000000,7.3,2008,Revolutionary Road,
RocknRolla,-12299374,5700626,18000000,7.3,2008,RocknRolla,
"New York, I Love You",-13111985,1588015,14700000,6.2,2008,"New York, I Love You",
Strange Wilderness,-13424718,6575282,20000000,5.3,2008,Strange Wilderness,
Brideshead Revisited,-13567744,6432256,20000000,6.7,2008,Brideshead Revisited,
Stop-Loss,-14084256,10915744,25000000,6.4,2008,Stop-Loss,
Pride and Glory,-14259279,15740721,30000000,6.6,2008,Pride and Glory,
The Lucky Ones,-14733033,266967,15000000,6.9,2008,The Lucky Ones,
The Other Man,-14850472,149528,15000000,5.4,2008,The Other Man,
The Midnight Meat Train,-14916639,83361,15000000,6,2008,The Midnight Meat Train,
The Incredible Hulk,-15193087,134806913,150000000,6.7,2008,The Incredible Hulk,
Flash of Genius,-15557623,4442377,20000000,7,2008,Flash of Genius,
The Brothers Bloom,-16468244,3531756,20000000,6.8,2008,The Brothers Bloom,
"Synecdoche, New York",-16916462,3083538,20000000,7.6,2008,"Synecdoche, New York",
The Informers,-17700000,300000,18000000,5,2008,The Informers,
The Spiderwick Chronicles,-18804947,71195053,90000000,6.5,2008,The Spiderwick Chronicles,
Doomsday,-18991230,11008770,30000000,6,2008,Doomsday,
Changeling,-19260198,35739802,55000000,7.7,2008,Changeling,
The Burning Plain,-19799270,200730,20000000,6.8,2008,The Burning Plain,
Righteous Kill,-19918590,40081410,60000000,6,2008,Righteous Kill,
Deception,-20401494,4598506,25000000,6.1,2008,Deception,
Semi-Pro,-21520302,33479698,55000000,5.8,2008,Semi-Pro,
The Curious Case of Benjamin Button,-22490674,127509326,150000000,7.8,2008,The Curious Case of Benjamin Button,
Me and Orson Welles,-23809997,1190003,25000000,6.7,2008,Me and Orson Welles,
What Just Happened,-23909053,1090947,25000000,5.6,2008,What Just Happened,
Passengers,-24707563,292437,25000000,5.9,2008,Passengers,
Mutant Chronicles,-24993180,6820,25000000,5.2,2008,Mutant Chronicles,
Leatherheads,-26626062,31373938,58000000,6,2008,Leatherheads,
Punisher: War Zone,-26949023,8050977,35000000,5.9,2008,Punisher: War Zone,
Bangkok Dangerous,-29701867,15298133,45000000,5.4,2008,Bangkok Dangerous,
The Love Guru,-29764207,32235793,62000000,3.8,2008,The Love Guru,
The Express,-30206594,9793406,40000000,7.3,2008,The Express,
Body of Lies,-30605334,39394666,70000000,7.1,2008,Body of Lies,
Quantum of Solace,-31631573,168368427,200000000,6.6,2008,Quantum of Solace,
Bolt,-35946421,114053579,150000000,6.8,2008,Bolt,
Miracle at St. Anna,-37080883,7919117,45000000,6.1,2008,Miracle at St. Anna,
The Spirit,-40193812,19806188,60000000,4.8,2008,The Spirit,
The Mummy: Tomb of the Dragon Emperor,-42508224,102491776,145000000,5.2,2008,The Mummy: Tomb of the Dragon Emperor,
Inkheart,-42696576,17303424,60000000,6.1,2008,Inkheart,
City of Ember,-47126993,7873007,55000000,6.5,2008,City of Ember,
Babylon A.D.,-47467428,22532572,70000000,5.6,2008,Babylon A.D.,
Meet Dave,-48196746,11803254,60000000,5,2008,Meet Dave,
Outlander,-49833997,166003,50000000,6.2,2008,Outlander,
Speed Racer,-76054234,43945766,120000000,6,2008,Speed Racer,
Australia,-80445998,49554002,130000000,6.6,2008,Australia,
The Chronicles of Narnia: Prince Caspian,-83378510,141621490,225000000,6.5,2008,The Chronicles of Narnia: Prince Caspian,
Avatar,523507625,760507625,237000000,7.8,2009,Avatar,
The Twilight Saga: New Moon,247816253,297816253,50000000,4.7,2009,The Twilight Saga: New Moon,
The Hangover,242322503,277322503,35000000,7.7,2009,The Hangover,
The Blind Side,226959475,255959475,29000000,7.6,2009,The Blind Side,
Transformers: Revenge of the Fallen,202111870,402111870,200000000,6,2009,Transformers: Revenge of the Fallen,
Alvin and the Chipmunks: The Squeakquel,144614612,219614612,75000000,4.5,2009,Alvin and the Chipmunks: The Squeakquel,
The Proposal,123958031,163958031,40000000,6.7,2009,The Proposal,
Paul Blart: Mall Cop,120336178,146336178,26000000,5.2,2009,Paul Blart: Mall Cop,
Sherlock Holmes,119028679,209028679,90000000,7.6,2009,Sherlock Holmes,
Up,118004164,293004164,175000000,8.2,2009,Up,
Star Trek,107730019,257730019,150000000,7.9,2009,Star Trek,
Ice Age: Dawn of the Dinosaurs,106573705,196573705,90000000,6.9,2009,Ice Age: Dawn of the Dinosaurs,
District 9,85646235,115646235,30000000,7.9,2009,District 9,
Fast & Furious,70064265,155064265,85000000,6.6,2009,Fast & Furious,
Up in the Air,58823381,83823381,25000000,7.4,2009,Up in the Air,
Julie & Julia,54125426,94125426,40000000,7,2009,Julie & Julia,
He's Just Not That Into You,53953653,93953653,40000000,6.4,2009,He's Just Not That Into You,
Harry Potter and the Half-Blood Prince,52305431,302305431,250000000,7.6,2009,Harry Potter and the Half-Blood Prince,
Zombieland,51990286,75590286,23600000,7.6,2009,Zombieland,
The Ugly Truth,50915214,88915214,38000000,6.4,2009,The Ugly Truth,
Inglourious Basterds,50540719,120540719,70000000,8.3,2009,Inglourious Basterds,
Hannah Montana: The Movie,49576189,79576189,30000000,4.5,2009,Hannah Montana: The Movie,
Obsessed,48261644,68261644,20000000,5,2009,Obsessed,
Friday the 13th,46002019,65002019,19000000,5.5,2009,Friday the 13th,
The Haunting in Connecticut,45389516,55389516,10000000,5.9,2009,The Haunting in Connecticut,
17 Again,44167069,64167069,20000000,6.3,2009,17 Again,
Couples Retreat,39204945,109204945,70000000,5.5,2009,Couples Retreat,
Hotel for Dogs,38034460,73034460,35000000,5.4,2009,Hotel for Dogs,
Precious,37566524,47566524,10000000,7.3,2009,Precious,
My Bloody Valentine,36545952,51545952,15000000,5.4,2009,My Bloody Valentine,
Crazy Heart,32464306,39464306,7000000,7.2,2009,Crazy Heart,
"I Love You, Man",31440011,71440011,40000000,7,2009,"I Love You, Man",
Knowing,29957634,79957634,50000000,6.2,2009,Knowing,
X-Men Origins: Wolverine,29883157,179883157,150000000,6.6,2009,X-Men Origins: Wolverine,
Bride Wars,28715510,58715510,30000000,5.5,2009,Bride Wars,
It's Complicated,27735375,112735375,85000000,6.5,2009,It's Complicated,
Night at the Museum: Battle of the Smithsonian,27243721,177243721,150000000,6,2009,Night at the Museum: Battle of the Smithsonian,
The Unborn,26670410,42670410,16000000,4.8,2009,The Unborn,
The Final Destination,26477700,66477700,40000000,5.2,2009,The Final Destination,
(500) Days of Summer,24891374,32391374,7500000,7.7,2009,(500) Days of Summer,
Cloudy with a Chance of Meatballs,24870275,124870275,100000000,6.9,2009,Cloudy with a Chance of Meatballs,
The Time Traveler's Wife,24414846,63414846,39000000,7.1,2009,The Time Traveler's Wife,
Law Abiding Citizen,23357727,73357727,50000000,7.4,2009,Law Abiding Citizen,
Monsters vs. Aliens,23351526,198351526,175000000,6.4,2009,Monsters vs. Aliens,
My Sister's Keeper,19200230,49200230,30000000,7.4,2009,My Sister's Keeper,
All About Steve,18862903,33862903,15000000,4.8,2009,All About Steve,
Halloween II,18392973,33392973,15000000,4.9,2009,Halloween II,
Br√ºno,18054530,60054530,42000000,5.8,2009,Br√ºno,
The Last House on the Left,17752215,32752215,15000000,6.5,2009,The Last House on the Left,
Ghosts of Girlfriends Past,17750026,55250026,37500000,5.8,2009,Ghosts of Girlfriends Past,
Notorious,16843682,36843682,20000000,6.7,2009,Notorious,
Saw VI,16693292,27693292,11000000,6,2009,Saw VI,
The Fourth Kind,15486040,25486040,10000000,5.9,2009,The Fourth Kind,
Coraline,15286229,75286229,60000000,7.7,2009,Coraline,
Old Dogs,14492060,49492060,35000000,5.4,2009,Old Dogs,
Drag Me to Hell,12100625,42100625,30000000,6.5,2009,Drag Me to Hell,
The Informant!,11316821,33316821,22000000,6.4,2009,The Informant!,
Underworld: Rise of the Lycans,10802315,45802315,35000000,6.6,2009,Underworld: Rise of the Lycans,
Brooklyn's Finest,10163593,27163593,17000000,6.7,2009,Brooklyn's Finest,
Daybreakers,10101577,30101577,20000000,6.4,2009,Daybreakers,
The Stepfather,9062561,29062561,20000000,5.6,2009,The Stepfather,
New in Town,8734283,16734283,8000000,5.6,2009,New in Town,
The Men Who Stare at Goats,7428195,32428195,25000000,6.2,2009,The Men Who Stare at Goats,
Next Day Air,7027047,10027047,3000000,5.8,2009,Next Day Air,
Observe and Report,6007324,24007324,18000000,5.8,2009,Observe and Report,
"The Goods: Live Hard, Sell Hard",5122676,15122676,10000000,5.8,2009,"The Goods: Live Hard, Sell Hard",
An Education,5074914,12574914,7500000,7.3,2009,An Education,
Love Happens,4965110,22965110,18000000,5.7,2009,Love Happens,
Fame,4455510,22455510,18000000,5.1,2009,Fame,
Extract,2823158,10823158,8000000,6.1,2009,Extract,
Brothers,2544157,28544157,26000000,7.1,2009,Brothers,
The Boondock Saints II: All Saints Day,2273188,10273188,8000000,6.3,2009,The Boondock Saints II: All Saints Day,
A Serious Man,2228768,9228768,7000000,7,2009,A Serious Man,
Get Low,2176933,9176933,7000000,7,2009,Get Low,
A Single Man,2176000,9176000,7000000,7.6,2009,A Single Man,
Race to Witch Mountain,2172594,67172594,65000000,5.7,2009,Race to Witch Mountain,
9,1749894,31749894,30000000,7.1,2009,9,
The Collector,1712114,7712114,6000000,6.4,2009,The Collector,
A Perfect Getaway,1515460,15515460,14000000,6.5,2009,A Perfect Getaway,
City Island,671036,6671036,6000000,7.4,2009,City Island,
Dance Flick,662155,25662155,25000000,3.5,2009,Dance Flick,
Jennifer's Body,204793,16204793,16000000,5.2,2009,Jennifer's Body,
Moon,10163,5010163,5000000,7.9,2009,Moon,
The Invention of Lying,-48749,18451251,18500000,6.4,2009,The Invention of Lying,
Sorority Row,-534718,11965282,12500000,5.1,2009,Sorority Row,
The Princess and the Frog,-599101,104400899,105000000,7.1,2009,The Princess and the Frog,
The House of the Devil,-798785,101215,900000,6.4,2009,The House of the Devil,
The Girlfriend Experience,-1004160,695840,1700000,5.5,2009,The Girlfriend Experience,
Miss March,-1456680,4543320,6000000,5,2009,Miss March,
Ninja Assassin,-1877117,38122883,40000000,6.3,2009,Ninja Assassin,
Whip It,-1956637,13043363,15000000,6.9,2009,Whip It,
Black Dynamite,-2657422,242578,2900000,7.4,2009,Black Dynamite,
Youth in Revolt,-2718714,15281286,18000000,6.4,2009,Youth in Revolt,
Fired Up!,-2768709,17231291,20000000,6.1,2009,Fired Up!,
Public Enemies,-2895380,97104620,100000000,7,2009,Public Enemies,
"I Love You, Beth Cooper",-3199275,14800725,18000000,5.3,2009,"I Love You, Beth Cooper",
Fanboys,-3211471,688529,3900000,6.6,2009,Fanboys,
Defendor,-3455538,44462,3500000,6.8,2009,Defendor,
Survival of the Dead,-3898260,101740,4000000,4.9,2009,Survival of the Dead,
Armored,-4011124,15988876,20000000,5.7,2009,Armored,
After.Life,-4391405,108595,4500000,5.9,2009,After.Life,
Tetro,-4481478,518522,5000000,6.8,2009,Tetro,
Shrink,-4910379,189621,5100000,6.6,2009,Shrink,
The Messenger,-5390340,1109660,6500000,7.1,2009,The Messenger,
Mother and Child,-5889491,1110509,7000000,7.2,2009,Mother and Child,
Push,-6188473,31811527,38000000,6.1,2009,Push,
Crank: High Voltage,-6315751,13684249,20000000,6.2,2009,Crank: High Voltage,
The Secret of Kells,-7323225,676775,8000000,7.6,2009,The Secret of Kells,
Away We Go,-7548054,9451946,17000000,7,2009,Away We Go,
My Life in Ruins,-8334794,8665206,17000000,5.9,2009,My Life in Ruins,
The Joneses,-8524254,1475746,10000000,6.5,2009,The Joneses,
Post Grad,-8619981,6380019,15000000,5.3,2009,Post Grad,
Leaves of Grass,-8929934,70066,9000000,6.4,2009,Leaves of Grass,
Street Fighter: The Legend of Chun-Li,-9257739,8742261,18000000,3.7,2009,Street Fighter: The Legend of Chun-Li,
Whatever Works,-9693294,5306706,15000000,7.1,2009,Whatever Works,
12 Rounds,-9765306,12234694,22000000,5.6,2009,12 Rounds,
Gentlemen Broncos,-9886318,113682,10000000,6.2,2009,Gentlemen Broncos,
Solitary Man,-10639452,4360548,15000000,6.3,2009,Solitary Man,
Chloe,-10924745,3075255,14000000,6.3,2009,Chloe,
I Love You Phillip Morris,-10962541,2037459,13000000,6.6,2009,I Love You Phillip Morris,
Ondine,-11449528,550472,12000000,6.8,2009,Ondine,
Everybody's Fine,-11791124,9208876,21000000,7.1,2009,Everybody's Fine,
Case 39,-12738149,13261851,26000000,6.2,2009,Case 39,
Splice,-12989830,17010170,30000000,5.7,2009,Splice,
Bandslam,-14789012,5210988,20000000,6.3,2009,Bandslam,
The Box,-14948023,15051977,30000000,5.6,2009,The Box,
Angels & Demons,-16624154,133375846,150000000,6.7,2009,Angels & Demons,
Year One,-16662721,43337279,60000000,4.9,2009,Year One,
The Road,-16883000,8117000,25000000,7.2,2009,The Road,
Crossing Over,-18544346,455654,19000000,6.7,2009,Crossing Over,
Fantastic Mr. Fox,-18997081,21002919,40000000,7.9,2009,Fantastic Mr. Fox,
Middle Men,-19245699,754301,20000000,6.8,2009,Middle Men,
Duplicity,-19427175,40572825,60000000,6.1,2009,Duplicity,
Aliens in the Attic,-19799588,25200412,45000000,5.4,2009,Aliens in the Attic,
Dragonball Evolution,-20637215,9362785,30000000,2.5,2009,Dragonball Evolution,
The Lovely Bones,-20885768,44114232,65000000,6.7,2009,The Lovely Bones,
Watchmen,-22490201,107509799,130000000,7.6,2009,Watchmen,
Invictus,-22508636,37491364,60000000,7.3,2009,Invictus,
Taking Woodstock,-22539796,7460204,30000000,6.7,2009,Taking Woodstock,
Pandorum,-22669147,10330853,33000000,6.7,2009,Pandorum,
Where the Wild Things Are,-22766533,77233467,100000000,6.7,2009,Where the Wild Things Are,
Funny People,-23144955,51855045,75000000,6.3,2009,Funny People,
The Bad Lieutenant: Port of Call - New Orleans,-23297888,1702112,25000000,6.6,2009,The Bad Lieutenant: Port of Call - New Orleans,
The Young Victoria,-23998728,11001272,35000000,7.3,2009,The Young Victoria,
The International,-24549473,25450527,50000000,6.5,2009,The International,
Whiteout,-24724362,10275638,35000000,5.5,2009,Whiteout,
G.I. Joe: The Rise of Cobra,-24798502,150201498,175000000,5.8,2009,G.I. Joe: The Rise of Cobra,
Beyond a Reasonable Doubt,-24967083,32917,25000000,5.9,2009,Beyond a Reasonable Doubt,
Amelia,-25753512,14246488,40000000,5.8,2009,Amelia,
Cirque du Freak: The Vampire's Assistant,-26130485,13869515,40000000,5.8,2009,Cirque du Freak: The Vampire's Assistant,
Planet 51,-27805940,42194060,70000000,6,2009,Planet 51,
The Soloist,-28279842,31720158,60000000,6.7,2009,The Soloist,
Did You Hear About the Morgans?,-28419913,29580087,58000000,4.8,2009,Did You Hear About the Morgans?,
Gamer,-29465093,20534907,50000000,5.8,2009,Gamer,
2012,-33887833,166112167,200000000,5.8,2009,2012,
The Pink Panther 2,-34077022,35922978,70000000,5.6,2009,The Pink Panther 2,
The Taking of Pelham 123,-34547688,65452312,100000000,6.4,2009,The Taking of Pelham 123,
Imagine That,-38876677,16123323,55000000,5.6,2009,Imagine That,
Surrogates,-41422228,38577772,80000000,6.3,2009,Surrogates,
Astro Boy,-45448933,19551067,65000000,6.3,2009,Astro Boy,
Mr. Nobody,-46996378,3622,47000000,7.8,2009,Mr. Nobody,
Land of the Lost,-50561630,49438370,100000000,5.3,2009,Land of the Lost,
Nine,-60323035,19676965,80000000,5.8,2009,Nine,
A Christmas Carol,-62144137,137855863,200000000,6.8,2009,A Christmas Carol,
Terminator Salvation,-74677531,125322469,200000000,6.5,2009,Terminator Salvation,
The Twilight Saga: Eclipse,232531751,300531751,68000000,5,2010,The Twilight Saga: Eclipse,
Toy Story 3,215004880,415004880,200000000,8.3,2010,Toy Story 3,
Despicable Me,182513985,251513985,69000000,7.6,2010,Despicable Me,
The Karate Kid,136591618,176591618,40000000,6.2,2010,The Karate Kid,
Alice in Wonderland,134191110,334191110,200000000,6.4,2010,Alice in Wonderland,
True Grit,133243005,171243005,38000000,7.6,2010,True Grit,
Inception,132576195,292576195,160000000,8.8,2010,Inception,
The King's Speech,123797449,138797449,15000000,8,2010,The King's Speech,
Iron Man 2,112433331,312433331,200000000,7,2010,Iron Man 2,
Black Swan,93954678,106954678,13000000,8,2010,Black Swan,
Grown Ups,82001186,162001186,80000000,5.9,2010,Grown Ups,
Paranormal Activity 2,81752907,84752907,3000000,5.6,2010,Paranormal Activity 2,
Shrek Forever After,73736787,238736787,165000000,6.3,2010,Shrek Forever After,
The Fighter,68617009,93617009,25000000,7.8,2010,The Fighter,
Valentine's Day,58485654,110485654,52000000,5.7,2010,Valentine's Day,
The Social Network,56962694,96962694,40000000,7.7,2010,The Social Network,
The Town,55186262,92186262,37000000,7.5,2010,The Town,
Dear John,55014842,80014842,25000000,6.3,2010,Dear John,
How to Train Your Dragon,52581231,217581231,165000000,8.1,2010,How to Train Your Dragon,
Insidious,52509150,54009150,1500000,6.8,2010,Insidious,
Easy A,50401464,58401464,8000000,7,2010,Easy A,
Diary of a Wimpy Kid,49003625,64003625,15000000,6.2,2010,Diary of a Wimpy Kid,
Little Fockers,48438600,148438600,100000000,5.5,2010,Little Fockers,
Shutter Island,48012934,128012934,80000000,8.2,2010,Shutter Island,
Date Night,43711404,98711404,55000000,6.3,2010,Date Night,
The Last Song,42950384,62950384,20000000,6,2010,The Last Song,
The Last Exorcism,39234350,41034350,1800000,5.6,2010,The Last Exorcism,
Clash of the Titans,38214888,163214888,125000000,5.8,2010,Clash of the Titans,
Due Date,35539043,100539043,65000000,6.5,2010,Due Date,
RED,32380162,90380162,58000000,7,2010,RED,
A Nightmare on Elm Street,28075011,63075011,35000000,5.2,2010,A Nightmare on Elm Street,
The Bounty Hunter,27061228,67061228,40000000,5.6,2010,The Bounty Hunter,
Takers,25744720,57744720,32000000,6.2,2010,Takers,
Saw 3D,25710178,45710178,20000000,5.6,2010,Saw 3D,
Secretariat,24713955,59713955,35000000,7.2,2010,Secretariat,
Devil,23601190,33601190,10000000,6.2,2010,Devil,
The Expendables,23068524,103068524,80000000,6.5,2010,The Expendables,
Letters to Juliet,23032453,53032453,30000000,6.5,2010,Letters to Juliet,
Death at a Funeral,21739347,42739347,21000000,5.7,2010,Death at a Funeral,
Get Him to the Greek,20974475,60974475,40000000,6.4,2010,Get Him to the Greek,
Eat Pray Love,20574010,80574010,60000000,5.8,2010,Eat Pray Love,
Yogi Bear,20246011,100246011,80000000,4.6,2010,Yogi Bear,
The Other Guys,19219978,119219978,100000000,6.6,2010,The Other Guys,
The Crazies,19123589,39123589,20000000,6.5,2010,The Crazies,
Megamind,18415853,148415853,130000000,7.2,2010,Megamind,
Kick-Ass,18071303,48071303,30000000,7.6,2010,Kick-Ass,
The Kids Are All Right,16811365,20811365,4000000,7,2010,The Kids Are All Right,
Vampires Suck,16661504,36661504,20000000,3.4,2010,Vampires Suck,
Machete,16093646,26593646,10500000,6.6,2010,Machete,
The American,15606376,35606376,20000000,6.3,2010,The American,
Life as We Know It,15374681,53374681,38000000,6.5,2010,Life as We Know It,
Cop Out,14875481,44875481,30000000,5.6,2010,Cop Out,
The Book of Eli,14835059,94835059,80000000,6.9,2010,The Book of Eli,
Hot Tub Time Machine,14287556,50287556,36000000,6.4,2010,Hot Tub Time Machine,
Legion,14168080,40168080,26000000,5.2,2010,Legion,
Step Up 3D,12400223,42400223,30000000,6.2,2010,Step Up 3D,
Tooth Fairy,12022256,60022256,48000000,5,2010,Tooth Fairy,
She's Out of My League,12010860,32010860,20000000,6.4,2010,She's Out of My League,
Predators,12000688,52000688,40000000,6.4,2010,Predators,
Skyline,11393620,21393620,10000000,4.4,2010,Skyline,
The Debt,11177548,31177548,20000000,6.8,2010,The Debt,
Ramona and Beezus,11167002,26167002,15000000,6.5,2010,Ramona and Beezus,
The Switch,8779426,27779426,19000000,6.1,2010,The Switch,
Blue Valentine,8706328,9706328,1000000,7.4,2010,Blue Valentine,
Salt,8311368,118311368,110000000,6.4,2010,Salt,
Lottery Ticket,7719879,24719879,17000000,5,2010,Lottery Ticket,
Leap Year,6918920,25918920,19000000,6.5,2010,Leap Year,
You Again,5702053,25702053,20000000,5.8,2010,You Again,
Country Strong,5218921,20218921,15000000,6.3,2010,Country Strong,
Alpha and Omega,5107267,25107267,20000000,5.2,2010,Alpha and Omega,
Winter's Bone,4531503,6531503,2000000,7.2,2010,Winter's Bone,
Dinner for Schmucks,4026337,73026337,69000000,5.9,2010,Dinner for Schmucks,
Remember Me,3068240,19068240,16000000,7.1,2010,Remember Me,
Beginners,2590894,5790894,3200000,7.2,2010,Beginners,
The Back-up Plan,2490007,37490007,35000000,5.4,2010,The Back-up Plan,
Love & Other Drugs,2367005,32367005,30000000,6.7,2010,Love & Other Drugs,
Tron,2062763,172062763,170000000,6.8,2010,Tron,
Please Give,1033574,4033574,3000000,6.6,2010,Please Give,
Piranha 3D,1003155,25003155,24000000,5.4,2010,Piranha 3D,
Cyrus,468936,7468936,7000000,6.3,2010,Cyrus,
127 Hours,335230,18335230,18000000,7.5,2010,127 Hours,
Tiny Furniture,326674,391674,65000,6.2,2010,Tiny Furniture,
Resident Evil: Afterlife,128566,60128566,60000000,5.8,2010,Resident Evil: Afterlife,
The Perfect Host,-451236,48764,500000,6.8,2010,The Perfect Host,
Stake Land,-616755,33245,650000,6.5,2010,Stake Land,
Hatchet II,-747396,52604,800000,5.5,2010,Hatchet II,
Faster,-759980,23240020,24000000,6.4,2010,Faster,
Don't Be Afraid of the Dark,-953318,24046682,25000000,5.6,2010,Don't Be Afraid of the Dark,
Meek's Cutoff,-1022228,977772,2000000,6.5,2010,Meek's Cutoff,
The Losers,-1408568,23591432,25000000,6.3,2010,The Losers,
MacGruber,-1474400,8525600,10000000,5.5,2010,MacGruber,
It's Kind of a Funny Story,-1636372,6363628,8000000,7.1,2010,It's Kind of a Funny Story,
I Spit on Your Grave,-1906949,93051,2000000,6.3,2010,I Spit on Your Grave,
Super,-2172284,327716,2500000,6.7,2010,Super,
Everything Must Go,-2288357,2711643,5000000,6.4,2010,Everything Must Go,
Rabbit Hole,-2770942,2229058,5000000,7,2010,Rabbit Hole,
The Spy Next Door,-3692914,24307086,28000000,5.4,2010,The Spy Next Door,
Trust,-3879984,120016,4000000,6.9,2010,Trust,
Dirty Girl,-3944875,55125,4000000,6.4,2010,Dirty Girl,
The Romantics,-4393476,106524,4500000,5.1,2010,The Romantics,
Sex and the City 2,-4652308,95347692,100000000,4.5,2010,Sex and the City 2,
Another Year,-4794294,3205706,8000000,7.3,2010,Another Year,
Twelve,-4816080,183920,5000000,5.7,2010,Twelve,
Waiting for Forever,-4974483,25517,5000000,6,2010,Waiting for Forever,
Somewhere,-5214355,1785645,7000000,6.3,2010,Somewhere,
Conviction,-5716871,6783129,12500000,7.2,2010,Conviction,
Nanny McPhee and the Big Bang,-5988785,29011215,35000000,6.1,2010,Nanny McPhee and the Big Bang,
Percy Jackson & the Olympians: The Lightning Thief,-6231697,88768303,95000000,5.9,2010,Percy Jackson & the Olympians: The Lightning Thief,
The Runaways,-6426327,3573673,10000000,6.5,2010,The Runaways,
Hesher,-6617054,382946,7000000,7,2010,Hesher,
Let Me In,-7865065,12134935,20000000,7.1,2010,Let Me In,
The Next Three Days,-8851349,21148651,30000000,7.4,2010,The Next Three Days,
Morning Glory,-8988268,31011732,40000000,6.5,2010,Morning Glory,
Vanishing on 7th Street,-9977271,22729,10000000,4.9,2010,Vanishing on 7th Street,
My Soul to Take,-10255565,14744435,25000000,4.8,2010,My Soul to Take,
The Company Men,-10558728,4441272,15000000,6.7,2010,The Company Men,
Centurion,-11876430,123570,12000000,6.4,2010,Centurion,
Henry's Crime,-11897459,102541,12000000,6,2010,Henry's Crime,
Flipped,-12244788,1755212,14000000,7.7,2010,Flipped,
Fair Game,-12459309,9540691,22000000,6.8,2010,Fair Game,
The Killer Inside Me,-12782723,217277,13000000,6.1,2010,The Killer Inside Me,
Charlie St. Cloud,-12837455,31162545,44000000,6.4,2010,Charlie St. Cloud,
The Conspirator,-13461796,11538204,25000000,6.9,2010,The Conspirator,
Going the Distance,-14195701,17804299,32000000,6.3,2010,Going the Distance,
Burlesque,-15559345,39440655,55000000,6.4,2010,Burlesque,
Marmaduke,-16355212,33644788,50000000,4.3,2010,Marmaduke,
Hereafter,-17253059,32746941,50000000,6.4,2010,Hereafter,
Furry Vengeance,-17369535,17630465,35000000,3.8,2010,Furry Vengeance,
Wall Street: Money Never Sleeps,-17525384,52474616,70000000,6.2,2010,Wall Street: Money Never Sleeps,
Repo Men,-18205165,13794835,32000000,6.3,2010,Repo Men,
The Last Airbender,-18227813,131772187,150000000,4,2010,The Last Airbender,
Unstoppable,-18437058,81562942,100000000,6.8,2010,Unstoppable,
You Will Meet a Tall Dark Stranger,-18751754,3248246,22000000,6.3,2010,You Will Meet a Tall Dark Stranger,
Dylan Dog: Dead of Night,-18813462,1186538,20000000,5.1,2010,Dylan Dog: Dead of Night,
Extraordinary Measures,-18931687,12068313,31000000,6.4,2010,Extraordinary Measures,
Stone,-20189922,1810078,22000000,5.4,2010,Stone,
When in Rome,-22319367,32680633,55000000,5.6,2010,When in Rome,
Legend of the Guardians: The Owls of Ga'Hoole,-24324687,55675313,80000000,6.9,2010,Legend of the Guardians: The Owls of Ga'Hoole,
London Boulevard,-24983925,16075,25000000,6.2,2010,London Boulevard,
The Way Back,-27298141,2701859,30000000,7.3,2010,The Way Back,
Killers,-27940037,47059963,75000000,5.5,2010,Killers,
Scott Pilgrim vs. the World,-28475725,31524275,60000000,7.5,2010,Scott Pilgrim vs. the World,
The Tourist,-32368843,67631157,100000000,6,2010,The Tourist,
The A-Team,-32777901,77222099,110000000,6.7,2010,The A-Team,
Jonah Hex,-36452883,10547117,47000000,4.7,2010,Jonah Hex,
Edge of Darkness,-36686110,43313890,80000000,6.6,2010,Edge of Darkness,
Knight and Day,-40576965,76423035,117000000,6.3,2010,Knight and Day,
Cats & Dogs: The Revenge of Kitty Galore,-41414247,43585753,85000000,4.3,2010,Cats & Dogs: The Revenge of Kitty Galore,
The Chronicles of Narnia: The Voyage of the Dawn Treader,-50613050,104386950,155000000,6.3,2010,The Chronicles of Narnia: The Voyage of the Dawn Treader,
Tangled,-59178064,200821936,260000000,7.7,2010,Tangled,
Green Zone,-64946340,35053660,100000000,6.8,2010,Green Zone,
Gulliver's Travels,-69220739,42779261,112000000,4.9,2010,Gulliver's Travels,
The Sorcerer's Apprentice,-86849009,63150991,150000000,6.1,2010,The Sorcerer's Apprentice,
The Wolfman,-88020320,61979680,150000000,5.8,2010,The Wolfman,
How Do You Know,-89787380,30212620,120000000,5.4,2010,How Do You Know,
Robin Hood,-94730270,105269730,200000000,6.6,2010,Robin Hood,
Prince of Persia: The Sands of Time,-109240324,90759676,200000000,6.6,2010,Prince of Persia: The Sands of Time,
Harry Potter and the Deathly Hallows: Part 2,256409310,381409310,125000000,8.1,2011,Harry Potter and the Deathly Hallows: Part 2,
The Hangover Part II,174464305,254464305,80000000,6.4,2011,The Hangover Part II,
The Twilight Saga: Breaking Dawn - Part 1,171287133,281287133,110000000,4.9,2011,The Twilight Saga: Breaking Dawn - Part 1,
Transformers: Dark of the Moon,157390543,352390543,195000000,6.2,2011,Transformers: Dark of the Moon,
The Help,144708112,169708112,25000000,8,2011,The Help,
Bridesmaids,136606725,169106725,32500000,6.8,2011,Bridesmaids,
Paranormal Activity 3,99028807,104028807,5000000,5.8,2011,Paranormal Activity 3,
Fast Five,84837675,209837675,125000000,7.3,2011,Fast Five,
Rise of the Planet of the Apes,83760185,176760185,93000000,7.6,2011,Rise of the Planet of the Apes,
Horrible Bosses,82538559,117538559,35000000,6.9,2011,Horrible Bosses,
Bad Teacher,80292856,100292856,20000000,5.6,2011,Bad Teacher,
Super 8,77004179,127004179,50000000,7,2011,Super 8,
Mission: Impossible - Ghost Protocol,64397903,209397903,145000000,7.4,2011,Mission: Impossible - Ghost Protocol,
Gnomeo & Juliet,63967670,99967670,36000000,5.9,2011,Gnomeo & Juliet,
The Descendants,62584160,82584160,20000000,7.3,2011,The Descendants,
Sherlock Holmes: A Game of Shadows,61848418,186848418,125000000,7.5,2011,Sherlock Holmes: A Game of Shadows,
Alvin and the Chipmunks: Chipwrecked,58110742,133110742,75000000,4.3,2011,Alvin and the Chipmunks: Chipwrecked,
Rio,53619809,143619809,90000000,6.9,2011,Rio,
Limitless,52249455,79249455,27000000,7.4,2011,Limitless,
No Strings Attached,45662220,70662220,25000000,6.2,2011,No Strings Attached,
Hop,45085305,108085305,63000000,5.4,2011,Hop,
The Muppets,43631237,88631237,45000000,7.1,2011,The Muppets,
Midnight in Paris,39817045,56817045,17000000,7.7,2011,Midnight in Paris,
Captain America: The First Avenger,36654505,176654505,140000000,6.9,2011,Captain America: The First Avenger,
The Best Exotic Marigold Hotel,36412041,46412041,10000000,7.2,2011,The Best Exotic Marigold Hotel,
Dolphin Tale,35286779,72286779,37000000,6.9,2011,Dolphin Tale,
"Crazy, Stupid, Love.",34351197,84351197,50000000,7.4,2011,"Crazy, Stupid, Love.",
Unknown,33686397,63686397,30000000,6.8,2011,Unknown,
The Smurfs,32614158,142614158,110000000,5.4,2011,The Smurfs,
Courageous,32522221,34522221,2000000,7,2011,Courageous,
Diary of a Wimpy Kid: Rodrick Rules,31698535,52698535,21000000,6.5,2011,Diary of a Wimpy Kid: Rodrick Rules,
Thor,31030624,181030624,150000000,7,2011,Thor,
The Artist,29671682,44671682,15000000,7.9,2011,The Artist,
The Ides of March,28462534,40962534,12500000,7.1,2011,The Ides of March,
Footloose,27802742,51802742,24000000,5.9,2011,Footloose,
50/50,27014192,35014192,8000000,7.6,2011,50/50,
The Grey,26580236,51580236,25000000,6.8,2011,The Grey,
Soul Surfer,25853424,43853424,18000000,7,2011,Soul Surfer,
We Bought a Zoo,25624550,75624550,50000000,7.1,2011,We Bought a Zoo,
Moneyball,25605492,75605492,50000000,7.6,2011,Moneyball,
Just Go with It,23028109,103028109,80000000,6.4,2011,Just Go with It,
Source Code,22712227,54712227,32000000,7.5,2011,Source Code,
The Roommate,21300000,37300000,16000000,4.8,2011,The Roommate,
Friends with Benefits,20802754,55802754,35000000,6.5,2011,Friends with Benefits,
Water for Elephants,20709717,58709717,38000000,6.9,2011,Water for Elephants,
Drive,20061555,35061555,15000000,7.8,2011,Drive,
Our Idiot Brother,19816118,24816118,5000000,6.4,2011,Our Idiot Brother,
Puss in Boots,19260504,149260504,130000000,6.6,2011,Puss in Boots,
The Lincoln Lawyer,18009200,58009200,40000000,7.3,2011,The Lincoln Lawyer,
You're Next,17494006,18494006,1000000,6.6,2011,You're Next,
A Very Harold & Kumar 3D Christmas,16061031,35061031,19000000,6.3,2011,A Very Harold & Kumar 3D Christmas,
Contagion,15658097,75658097,60000000,6.7,2011,Contagion,
Kung Fu Panda 2,15249063,165249063,150000000,7.2,2011,Kung Fu Panda 2,
War Horse,13884879,79884879,66000000,7.2,2011,War Horse,
Battle Los Angeles,13552429,83552429,70000000,5.7,2011,Battle Los Angeles,
Mr. Popper's Penguins,13224452,68224452,55000000,6,2011,Mr. Popper's Penguins,
Apollo 18,12687709,17687709,5000000,5.2,2011,Apollo 18,
The Girl with the Dragon Tattoo,12515793,102515793,90000000,7.8,2011,The Girl with the Dragon Tattoo,
The Adjustment Bureau,12295645,62495645,50200000,7,2011,The Adjustment Bureau,
The Cabin in the Woods,12073277,42073277,30000000,7,2011,The Cabin in the Woods,
Spy Kids 4: All the Time in the World,11538188,38538188,27000000,3.5,2011,Spy Kids 4: All the Time in the World,
Beastly,10865571,27865571,17000000,5.6,2011,Beastly,
Silent House,10754783,12754783,2000000,5.2,2011,Silent House,
Hanna,10259119,40259119,30000000,6.8,2011,Hanna,
Hall Pass,9060734,45060734,36000000,5.8,2011,Hall Pass,
30 Minutes or Less,9053924,37053924,28000000,6.1,2011,30 Minutes or Less,
Immortals,8504017,83504017,75000000,6,2011,Immortals,
"Big Mommas: Like Father, Like Son",5915414,37915414,32000000,4.4,2011,"Big Mommas: Like Father, Like Son",
Larry Crowne,5608245,35608245,30000000,6.1,2011,Larry Crowne,
The Sitter,5441326,30441326,25000000,5.7,2011,The Sitter,
Young Adult,4311571,16311571,12000000,6.2,2011,Young Adult,
Bernie,4206470,9206470,5000000,6.8,2011,Bernie,
Something Borrowed,4046489,39046489,35000000,5.9,2011,Something Borrowed,
Monte Carlo,3186769,23186769,20000000,5.8,2011,Monte Carlo,
Like Crazy,3145391,3395391,250000,6.7,2011,Like Crazy,
Tower Heist,3046570,78046570,75000000,6.2,2011,Tower Heist,
Final Destination 5,2587643,42587643,40000000,5.8,2011,Final Destination 5,
J. Edgar,2306030,37306030,35000000,6.5,2011,J. Edgar,
Prom,2130219,10130219,8000000,5.4,2011,Prom,
Margin Call,1854039,5354039,3500000,7.1,2011,Margin Call,
Your Sister's Sister,1511190,1636190,125000,6.7,2011,Your Sister's Sister,
Another Earth,1221194,1321194,100000,7,2011,Another Earth,
Zookeeper,360843,80360843,80000000,5.2,2011,Zookeeper,
The Innkeepers,-671604,78396,750000,5.4,2011,The Innkeepers,
One Day,-1156229,13843771,15000000,7,2011,One Day,
New Year's Eve,-1455362,54544638,56000000,5.7,2011,New Year's Eve,
Scream 4,-1819072,38180928,40000000,6.1,2011,Scream 4,
In Time,-2479905,37520095,40000000,6.7,2011,In Time,
Paul,-2587055,37412945,40000000,7,2011,Paul,
Shame,-2590998,3909002,6500000,7.2,2011,Shame,
Friends with Kids,-2748927,7251073,10000000,6.1,2011,Friends with Kids,
Red State,-2895318,1104682,4000000,6.2,2011,Red State,
Cedar Rapids,-3138898,6861102,10000000,6.2,2011,Cedar Rapids,
Take Shelter,-3269704,1730296,5000000,7.4,2011,Take Shelter,
Winnie the Pooh,-3307154,26692846,30000000,7.2,2011,Winnie the Pooh,
Colombiana,-3334146,36665854,40000000,6.4,2011,Colombiana,
The Rite,-3952367,33047633,37000000,6,2011,The Rite,
Haywire,-4057604,18942396,23000000,5.8,2011,Haywire,
Red Riding Hood,-4337838,37662162,42000000,5.5,2011,Red Riding Hood,
Jack and Jill,-4841843,74158157,79000000,3.3,2011,Jack and Jill,
I Am Number Four,-4899563,55100437,60000000,6.1,2011,I Am Number Four,
Albert Nobbs,-4985304,3014696,8000000,6.7,2011,Albert Nobbs,
Flypaper,-4994957,5043,5000000,6.4,2011,Flypaper,
Ghost Rider: Spirit of Vengeance,-5225998,51774002,57000000,4.3,2011,Ghost Rider: Spirit of Vengeance,
We Need to Talk About Kevin,-5261308,1738692,7000000,7.5,2011,We Need to Talk About Kevin,
The Eagle,-5509959,19490041,25000000,6.2,2011,The Eagle,
"Jeff, Who Lives at Home",-5730574,4269426,10000000,6.5,2011,"Jeff, Who Lives at Home",
What's Your Number?,-5988916,14011084,20000000,6.1,2011,What's Your Number?,
Shark Night 3D,-6122847,18877153,25000000,4,2011,Shark Night 3D,
Sanctum,-6790690,23209310,30000000,5.9,2011,Sanctum,
Abduction,-6912845,28087155,35000000,5.1,2011,Abduction,
Arthur,-6964603,33035397,40000000,5.7,2011,Arthur,
Bucky Larson: Born to Be a Star,-7470605,2529395,10000000,3.2,2011,Bucky Larson: Born to Be a Star,
Restless,-7836735,163265,8000000,6.8,2011,Restless,
Violet & Daisy,-7982814,17186,8000000,6.1,2011,Violet & Daisy,
Extremely Loud & Incredibly Close,-8152119,31847881,40000000,6.9,2011,Extremely Loud & Incredibly Close,
A Better Life,-8240748,1759252,10000000,7.2,2011,A Better Life,
Cars 2,-8547604,191452396,200000000,6.1,2011,Cars 2,
The Darkest Hour,-8556506,21443494,30000000,4.9,2011,The Darkest Hour,
Pirates of the Caribbean: On Stranger Tides,-8928198,241071802,250000000,6.6,2011,Pirates of the Caribbean: On Stranger Tides,
Killer Joe,-9012238,1987762,11000000,6.7,2011,Killer Joe,
The Ledge,-9990784,9216,10000000,6.5,2011,The Ledge,
Kill the Irishman,-10811806,1188194,12000000,7.1,2011,Kill the Irishman,
The Mechanic,-10878502,29121498,40000000,6.6,2011,The Mechanic,
Rampart,-11027488,972512,12000000,5.8,2011,Rampart,
Warrior,-11342885,13657115,25000000,8.2,2011,Warrior,
Rango,-11522393,123477607,135000000,7.2,2011,Rango,
Fright Night,-11697393,18302607,30000000,6.3,2011,Fright Night,
5 Days of War,-11982521,17479,12000000,5.6,2011,5 Days of War,
The Double,-13362079,137921,13500000,5.9,2011,The Double,
X: First Class,-13591695,146408305,160000000,7.7,2011,X: First Class,
Margaret,-13953505,46495,14000000,6.4,2011,Margaret,
I Don't Know How She Does It,-14337716,9662284,24000000,4.9,2011,I Don't Know How She Does It,
Straw Dogs,-14675559,10324441,25000000,5.8,2011,Straw Dogs,
The Change-Up,-14918525,37081475,52000000,6.3,2011,The Change-Up,
The Son of No One,-14969320,30680,15000000,5.1,2011,The Son of No One,
Season of the Witch,-15172772,24827228,40000000,5.4,2011,Season of the Witch,
Atlas Shrugged: Part I,-15372625,4627375,20000000,5.6,2011,Atlas Shrugged: Part I,
Take Me Home Tonight,-16071932,6928068,23000000,6.3,2011,Take Me Home Tonight,
Seeking Justice,-16588254,411746,17000000,6.2,2011,Seeking Justice,
The Tree of Life,-18696681,13303319,32000000,6.8,2011,The Tree of Life,
The Beaver,-20029184,970816,21000000,6.6,2011,The Beaver,
The Thing,-21071330,16928670,38000000,6.2,2011,The Thing,
The Green Hornet,-21219958,98780042,120000000,5.8,2011,The Green Hornet,
The Dilemma,-21524710,48475290,70000000,5.3,2011,The Dilemma,
Carnage,-22452953,2547047,25000000,7.2,2011,Carnage,
Real Steel,-24531492,85468508,110000000,7.1,2011,Real Steel,
Anonymous,-25536708,4463292,30000000,6.9,2011,Anonymous,
Your Highness,-28303555,21596445,49900000,5.5,2011,Your Highness,
Dream House,-28697660,21302340,50000000,6,2011,Dream House,
Machine Gun Preacher,-29461310,538690,30000000,6.8,2011,Machine Gun Preacher,
Priest,-30863000,29137000,60000000,5.7,2011,Priest,
The Rum Diary,-31890185,13109815,45000000,6.2,2011,The Rum Diary,
The Big Year,-33795862,7204138,41000000,6.2,2011,The Big Year,
Trespass,-34975906,24094,35000000,5.3,2011,Trespass,
Johnny English Reborn,-36694030,8305970,45000000,6.3,2011,Johnny English Reborn,
Drive Angry,-39278967,10721033,50000000,5.4,2011,Drive Angry,
Sucker Punch,-45607498,36392502,82000000,6,2011,Sucker Punch,
Arthur Christmas,-53537531,46462469,100000000,7.1,2011,Arthur Christmas,
The Three Musketeers,-54625516,20374484,75000000,5.7,2011,The Three Musketeers,
The Adventures of Tintin,-57408169,77591831,135000000,7.3,2011,The Adventures of Tintin,
Cowboys & Aliens,-62759449,100240551,163000000,6,2011,Cowboys & Aliens,
Conan the Barbarian,-68704979,21295021,90000000,5.2,2011,Conan the Barbarian,
Happy Feet Two,-70993534,64006466,135000000,5.9,2011,Happy Feet Two,
Hugo,-76135493,73864507,150000000,7.5,2011,Hugo,
Green Lantern,-83398828,116601172,200000000,5.5,2011,Green Lantern,
Mars Needs Moms,-128607242,21392758,150000000,5.4,2011,Mars Needs Moms,
The Avengers,403357910,623357910,220000000,8,2012,The Avengers,
The Hunger Games,330010692,408010692,78000000,7.2,2012,The Hunger Games,
The Dark Knight Rises,198139099,448139099,250000000,8.4,2012,The Dark Knight Rises,
The Twilight Saga: Breaking Dawn - Part 2,172324737,292324737,120000000,5.5,2012,The Twilight Saga: Breaking Dawn - Part 2,
Ted,168815487,218815487,50000000,6.9,2012,Ted,
The Lorax,144030500,214030500,70000000,6.4,2012,The Lorax,
The Hobbit: An Unexpected Journey,123003568,303003568,180000000,7.8,2012,The Hobbit: An Unexpected Journey,
Lincoln,117207973,182207973,65000000,7.3,2012,Lincoln,
Silver Linings Playbook,111092958,132092958,21000000,7.7,2012,Silver Linings Playbook,
Magic Mike,106721571,113721571,7000000,6.1,2012,Magic Mike,
Skyfall,104360277,304360277,200000000,7.7,2012,Skyfall,
21 Jump Street,96447667,138447667,42000000,7.2,2012,21 Jump Street,
The Vow,95014030,125014030,30000000,6.8,2012,The Vow,
Taken 2,94854287,139854287,45000000,6.3,2012,Taken 2,
Argo,91525503,136025503,44500000,7.7,2012,Argo,
Les Mis√©rables,87809770,148809770,61000000,7.6,2012,Les Mis√©rables,
Think Like a Man,79547205,91547205,12000000,6.6,2012,Think Like a Man,
Madagascar 3: Europe's Most Wanted,71391482,216391482,145000000,6.8,2012,Madagascar 3: Europe's Most Wanted,
Ice Age: Continental Drift,66321843,161321843,95000000,6.6,2012,Ice Age: Continental Drift,
Hotel Transylvania,63313048,148313048,85000000,7.1,2012,Hotel Transylvania,
Django Unchained,62805434,162805434,100000000,8.4,2012,Django Unchained,
Flight,62772375,93772375,31000000,7.3,2012,Flight,
Act of Valor,58012847,70012847,12000000,6.5,2012,Act of Valor,
Zero Dark Thirty,55720716,95720716,40000000,7.4,2012,Zero Dark Thirty,
Chronicle,52575175,64575175,12000000,7,2012,Chronicle,
Brave,52283207,237283207,185000000,7.1,2012,Brave,
Parental Guidance,52267296,77267296,25000000,6,2012,Parental Guidance,
The Devil Inside,52261944,53261944,1000000,4.2,2012,The Devil Inside,
Paranormal Activity 4,48885000,53885000,5000000,4.6,2012,Paranormal Activity 4,
Pitch Perfect,48001093,65001093,17000000,7.2,2012,Pitch Perfect,
Sinister,45086903,48086903,3000000,6.8,2012,Sinister,
Project X,42731865,54731865,12000000,6.6,2012,Project X,
Contraband,41528000,66528000,25000000,6.5,2012,Contraband,
Safe House,41373434,126373434,85000000,6.7,2012,Safe House,
The Woman in Black,37333290,54333290,17000000,6.4,2012,The Woman in Black,
Looper,36486205,66486205,30000000,7.4,2012,Looper,
The Lucky One,35457138,60457138,25000000,6.5,2012,The Lucky One,
The Possession,35130154,49130154,14000000,5.9,2012,The Possession,
End of Watch,34003371,41003371,7000000,7.6,2012,End of Watch,
Hope Springs,33536011,63536011,30000000,6.3,2012,Hope Springs,
This Is 40,32544505,67544505,35000000,6.2,2012,This Is 40,
The Amazing Spider-Man,32030663,262030663,230000000,6.9,2012,The Amazing Spider-Man,
Moonrise Kingdom,29512466,45512466,16000000,7.8,2012,Moonrise Kingdom,
Diary of a Wimpy Kid: Dog Days,27008662,49008662,22000000,6.3,2012,Diary of a Wimpy Kid: Dog Days,
The Odd Life of Timothy Green,26854875,51854875,25000000,6.6,2012,The Odd Life of Timothy Green,
Journey 2: The Mysterious Island,24860290,103860290,79000000,5.8,2012,Journey 2: The Mysterious Island,
Wreck-It Ralph,24422889,189422889,165000000,7.7,2012,Wreck-It Ralph,
House at the End of the Street,21611916,31611916,10000000,5.6,2012,House at the End of the Street,
Jack Reacher,20070736,80070736,60000000,7,2012,Jack Reacher,
Chernobyl Diaries,17119640,18119640,1000000,5,2012,Chernobyl Diaries,
Escape from Planet Earth,17012977,57012977,40000000,5.9,2012,Escape from Planet Earth,
The Three Stooges,14338224,44338224,30000000,5.1,2012,The Three Stooges,
Hit and Run,11749300,13749300,2000000,6.1,2012,Hit and Run,
Mud,11590086,21590086,10000000,7.4,2012,Mud,
Lawless,11400127,37400127,26000000,7.3,2012,Lawless,
Beasts of the Southern Wild,10995746,12795746,1800000,7.3,2012,Beasts of the Southern Wild,
Spring Breakers,9124284,14124284,5000000,5.3,2012,Spring Breakers,
American Reunion,7011521,57011521,50000000,6.7,2012,American Reunion,
The Place Beyond the Pines,6403519,21403519,15000000,7.3,2012,The Place Beyond the Pines,
Trouble with the Curve,5763137,35763137,30000000,6.8,2012,Trouble with the Curve,
The Words,5494838,11494838,6000000,7,2012,The Words,
The Sessions,5002451,6002451,1000000,7.2,2012,The Sessions,
The Perks of Being a Wallflower,4742948,17742948,13000000,8,2012,The Perks of Being a Wallflower,
Here Comes the Boom,3290318,45290318,42000000,6.4,2012,Here Comes the Boom,
Safety Not Guaranteed,3260957,4010957,750000,7,2012,Safety Not Guaranteed,
The Company You Keep,3133027,5133027,2000000,6.4,2012,The Company You Keep,
Savages,2382068,47382068,45000000,6.5,2012,Savages,
Step Up Revolution,2074677,35074677,33000000,6.4,2012,Step Up Revolution,
Sleepwalk with Me,1266067,2266067,1000000,6.8,2012,Sleepwalk with Me,
What to Expect When You're Expecting,1152203,41152203,40000000,5.7,2012,What to Expect When You're Expecting,
Robot & Frank,825038,3325038,2500000,7.1,2012,Robot & Frank,
The Man with the Iron Fists,634090,15634090,15000000,5.4,2012,The Man with the Iron Fists,
"For a Good Time, Call...",401749,1251749,850000,6,2012,"For a Good Time, Call...",
Compliance,49285,319285,270000,6.4,2012,Compliance,
Killing Them Softly,26056,15026056,15000000,6.2,2012,Killing Them Softly,
Seven Psychopaths,24049,15024049,15000000,7.2,2012,Seven Psychopaths,
Smashed,-123403,376597,500000,6.8,2012,Smashed,
The Lords of Salem,-334118,1165882,1500000,5.1,2012,The Lords of Salem,
It's a Disaster,-439182,60818,500000,6.4,2012,It's a Disaster,
Brake,-495124,4876,500000,6.1,2012,Brake,
The Collection,-657942,6842058,7500000,6.1,2012,The Collection,
The Brass Teapot,-893003,6997,900000,6.4,2012,The Brass Teapot,
The Five-Year Engagement,-1164472,28835528,30000000,6.2,2012,The Five-Year Engagement,
Liberal Arts,-1672655,327345,2000000,6.7,2012,Liberal Arts,
The First Time,-1977164,22836,2000000,6.8,2012,The First Time,
Bachelorette,-2552046,447954,3000000,5.3,2012,Bachelorette,
No One Lives,-2825082,74918,2900000,6,2012,No One Lives,
The Guilt Trip,-2865785,37134215,40000000,5.7,2012,The Guilt Trip,
Seeking a Friend for the End of the World,-2921262,7078738,10000000,6.7,2012,Seeking a Friend for the End of the World,
ATM,-2996990,3010,3000000,4.7,2012,ATM,
Prometheus,-3522916,126477084,130000000,7,2012,Prometheus,
People Like Us,-3565222,12434778,16000000,7.1,2012,People Like Us,
Frankenweenie,-3708932,35291068,39000000,6.9,2012,Frankenweenie,
ParaNorman,-3996949,56003051,60000000,7,2012,ParaNorman,
Arbitrage,-4080426,7919574,12000000,6.6,2012,Arbitrage,
Fun Size,-4590462,9409538,14000000,5.4,2012,Fun Size,
Piranha 3DD,-4623488,376512,5000000,3.7,2012,Piranha 3DD,
What Maisie Knew,-4933529,1066471,6000000,7.4,2012,What Maisie Knew,
The Dictator,-5349778,59650222,65000000,6.4,2012,The Dictator,
Ruby Sparks,-5459894,2540106,8000000,7.2,2012,Ruby Sparks,
Lockout,-5673136,14326864,20000000,6.1,2012,Lockout,
Maniac,-5968919,31081,6000000,6.1,2012,Maniac,
Promised Land,-7402102,7597898,15000000,6.6,2012,Promised Land,
Underworld Awakening,-7678961,62321039,70000000,6.4,2012,Underworld Awakening,
The Iceman,-8030807,1969193,10000000,6.8,2012,The Iceman,
The Campaign,-8092254,86907746,95000000,6.1,2012,The Campaign,
Red Tails,-8123623,49876377,58000000,5.9,2012,Red Tails,
Disconnect,-8563100,1436900,10000000,7.5,2012,Disconnect,
Alex Cross,-9111588,25888412,35000000,5.1,2012,Alex Cross,
Hitchcock,-9691323,6008677,15700000,6.8,2012,Hitchcock,
The Raven,-9991728,16008272,26000000,6.4,2012,The Raven,
Universal Soldier: Day of Reckoning,-9994540,5460,10000000,5,2012,Universal Soldier: Day of Reckoning,
This Means War,-10239209,54760791,65000000,6.3,2012,This Means War,
Stand Up Guys,-11689969,3310031,15000000,6.5,2012,Stand Up Guys,
The Bourne Legacy,-11796130,113203870,125000000,6.7,2012,The Bourne Legacy,
The Paperboy,-11806714,693286,12500000,5.8,2012,The Paperboy,
Deadfall,-11933649,66351,12000000,6.3,2012,Deadfall,
The Apparition,-12063181,4936819,17000000,4.1,2012,The Apparition,
Safe,-12857920,17142080,30000000,6.5,2012,Safe,
One for the Money,-13585473,26414527,40000000,5.3,2012,One for the Money,
Chasing Mavericks,-13997244,6002756,20000000,7.2,2012,Chasing Mavericks,
Snow White and the Huntsman,-14667619,155332381,170000000,6.1,2012,Snow White and the Huntsman,
Premium Rush,-14724554,20275446,35000000,6.5,2012,Premium Rush,
The Expendables 2,-14971808,85028192,100000000,6.6,2012,The Expendables 2,
The Master,-15622726,16377274,32000000,7.2,2012,The Master,
The Cold Light of Day,-16236417,3763583,20000000,4.9,2012,The Cold Light of Day,
The Oogieloves in the Big Balloon Adventure,-18934093,1065907,20000000,2.1,2012,The Oogieloves in the Big Balloon Adventure,
Big Miracle,-19842700,20157300,40000000,6.5,2012,Big Miracle,
Mirror Mirror,-20064833,64935167,85000000,5.6,2012,Mirror Mirror,
Red Dawn,-20193217,44806783,65000000,5.4,2012,Red Dawn,
A Thousand Words,-21549873,18450127,40000000,5.9,2012,A Thousand Words,
Playing for Keeps,-21896728,13103272,35000000,5.7,2012,Playing for Keeps,
Resident Evil: Retribution,-22654469,42345531,65000000,5.4,2012,Resident Evil: Retribution,
Man on a Ledge,-23380000,18620000,42000000,6.6,2012,Man on a Ledge,
The Pirates! In an Adventure with Scientists!,-23948874,31051126,55000000,6.7,2012,The Pirates! In an Adventure with Scientists!,
On the Road,-24255704,744296,25000000,6.1,2012,On the Road,
Lo imposible,-25980118,19019882,45000000,7.6,2012,Lo imposible,
Lay the Favorite,-26329002,20998,26350000,4.8,2012,Lay the Favorite,
Abraham Lincoln: Vampire Hunter,-31480861,37519139,69000000,5.9,2012,Abraham Lincoln: Vampire Hunter,
The Watch,-32647000,35353000,68000000,5.7,2012,The Watch,
That's My Boy,-33068911,36931089,70000000,5.5,2012,That's My Boy,
Stolen,-34695682,304318,35000000,5.5,2012,Stolen,
Bullet to the Head,-35510171,9489829,45000000,5.7,2012,Bullet to the Head,
Rock of Ages,-36481387,38518613,75000000,5.9,2012,Rock of Ages,
Dredd,-36585286,13414714,50000000,7.1,2012,Dredd,
Rise of the Guardians,-41587242,103412758,145000000,7.3,2012,Rise of the Guardians,
Men in Black 3,-45979146,179020854,225000000,6.8,2012,Men in Black 3,
Total Recall,-66122031,58877969,125000000,6.3,2012,Total Recall,
Wrath of the Titans,-66329917,83670083,150000000,5.7,2012,Wrath of the Titans,
Dark Shadows,-70272851,79727149,150000000,6.2,2012,Dark Shadows,
Cloud Atlas,-74891728,27108272,102000000,7.4,2012,Cloud Atlas,
Battleship,-143577375,65422625,209000000,5.8,2012,Battleship,
John Carter,-176921900,73078100,250000000,6.6,2012,John Carter,
The Hunger Games: Catching Fire,294668047,424668047,130000000,7.5,2013,The Hunger Games: Catching Fire,
Despicable Me 2,292065385,368065385,76000000,7.3,2013,Despicable Me 2,
Frozen,250738009,400738009,150000000,7.4,2013,Frozen,
Iron Man Three,209013994,409013994,200000000,7.2,2013,Iron Man Three,
Gravity,174092705,274092705,100000000,7.7,2013,Gravity,
The Conjuring,117400141,137400141,20000000,7.5,2013,The Conjuring,
The Heat,116582188,159582188,43000000,6.6,2013,The Heat,
We're the Millers,113394119,150394119,37000000,7,2013,We're the Millers,
American Hustle,110117807,150117807,40000000,7.2,2013,American Hustle,
Identity Thief,99506920,134506920,35000000,5.7,2013,Identity Thief,
Bad Grandpa,87003019,102003019,15000000,6.5,2013,Bad Grandpa,
The Butler,86632095,116632095,30000000,7.2,2013,The Butler,
Lone Survivor,85095601,125095601,40000000,7.5,2013,Lone Survivor,
Furious 6,78679850,238679850,160000000,7.1,2013,Furious 6,
Insidious: Chapter 2,78586447,83586447,5000000,6.6,2013,Insidious: Chapter 2,
Anchorman 2: The Legend Continues,77352707,127352707,50000000,6.3,2013,Anchorman 2: The Legend Continues,
This Is the End,69470202,101470202,32000000,6.6,2013,This Is the End,
Monsters University,68492764,268492764,200000000,7.3,2013,Monsters University,
Man of Steel,66045518,291045518,225000000,7,2013,Man of Steel,
The Purge,61473115,64473115,3000000,5.7,2013,The Purge,
42,55020213,95020213,40000000,7.5,2013,42,
Grown Ups 2,53668525,133668525,80000000,5.4,2013,Grown Ups 2,
The Best Man Holiday,53525195,70525195,17000000,6.7,2013,The Best Man Holiday,
The Croods,52168425,187168425,135000000,7.2,2013,The Croods,
Captain Phillips,52100855,107100855,55000000,7.8,2013,Captain Phillips,
Saving Mr. Banks,48301580,83301580,35000000,7.5,2013,Saving Mr. Banks,
Safe Haven,43349120,71349120,28000000,6.7,2013,Safe Haven,
Now You See Me,42723989,117723989,75000000,7.3,2013,Now You See Me,
Cloudy with a Chance of Meatballs 2,41793567,119793567,78000000,6.4,2013,Cloudy with a Chance of Meatballs 2,
Planes,40288712,90288712,50000000,5.7,2013,Planes,
The Great Gatsby,39840419,144840419,105000000,7.2,2013,The Great Gatsby,
The Call,38872378,51872378,13000000,6.7,2013,The Call,
Star Trek Into Darkness,38778661,228778661,190000000,7.7,2013,Star Trek Into Darkness,
A Haunted House,37541683,40041683,2500000,5,2013,A Haunted House,
Evil Dead,37239856,54239856,17000000,6.5,2013,Evil Dead,
12 Years a Slave,36671993,56671993,20000000,8.1,2013,12 Years a Slave,
Thor: The Dark World,36362140,206362140,170000000,6.9,2013,Thor: The Dark World,
Last Vegas,35914167,63914167,28000000,6.6,2013,Last Vegas,
The Hobbit: The Desolation of Smaug,33366855,258366855,225000000,7.8,2013,The Hobbit: The Desolation of Smaug,
Warm Bodies,31380662,66380662,35000000,6.9,2013,Warm Bodies,
Olympus Has Fallen,28925640,98925640,70000000,6.5,2013,Olympus Has Fallen,
Snitch,27930462,42930462,15000000,6.4,2013,Snitch,
Philomena,25709979,37709979,12000000,7.6,2013,Philomena,
Pain & Gain,23875291,49875291,26000000,6.4,2013,Pain & Gain,
Oculus,22695246,27695246,5000000,6.5,2013,Oculus,
Dallas Buyers Club,22298285,27298285,5000000,8,2013,Dallas Buyers Club,
Don Jon,21477704,24477704,3000000,6.5,2013,Don Jon,
Oz the Great and Powerful,19911825,234911825,215000000,6.3,2013,Oz the Great and Powerful,
The Wolf of Wall Street,16900694,116900694,100000000,8.2,2013,The Wolf of Wall Street,
The Way Way Back,16506546,21506546,5000000,7.4,2013,The Way Way Back,
Blue Jasmine,15405481,33405481,18000000,7.3,2013,Blue Jasmine,
Fruitvale Station,15201339,16101339,900000,7.5,2013,Fruitvale Station,
Prisoners,15002302,61002302,46000000,8.1,2013,Prisoners,
2 Guns,14612460,75612460,61000000,6.7,2013,2 Guns,
Texas Chainsaw 3D,14341945,34341945,20000000,4.8,2013,Texas Chainsaw 3D,
Dark Skies,13918667,17418667,3500000,6.3,2013,Dark Skies,
August: Osage County,12738810,37738810,25000000,7.2,2013,August: Osage County,
21 & Over,12682380,25682380,13000000,5.8,2013,21 & Over,
The Wolverine,12556852,132556852,120000000,6.7,2013,The Wolverine,
World War Z,12359711,202359711,190000000,7,2013,World War Z,
Scary Movie 5,12015787,32015787,20000000,3.5,2013,Scary Movie 5,
The Last Exorcism Part II,10179302,15179302,5000000,4,2013,The Last Exorcism Part II,
Enough Said,9550872,17550872,8000000,7,2013,Enough Said,
The Hangover Part III,9200072,112200072,103000000,5.8,2013,The Hangover Part III,
Begin Again,8170632,16170632,8000000,7.4,2013,Begin Again,
Epic,7518682,107518682,100000000,6.7,2013,Epic,
The Family,6918811,36918811,30000000,6.3,2013,The Family,
The World's End,6004851,26004851,20000000,7,2013,The World's End,
Hansel & Gretel: Witch Hunters,5703475,55703475,50000000,6.1,2013,Hansel & Gretel: Witch Hunters,
Nebraska,5654912,17654912,12000000,7.7,2013,Nebraska,
Carrie,5266619,35266619,30000000,5.9,2013,Carrie,
Before Midnight,5114627,8114627,3000000,7.9,2013,Before Midnight,
Admission,5007317,18007317,13000000,5.7,2013,Admission,
Delivery Man,4664106,30664106,26000000,6.4,2013,Delivery Man,
The Spectacular Now,4354611,6854611,2500000,7.1,2013,The Spectacular Now,
Jobs,4131410,16131410,12000000,5.9,2013,Jobs,
Riddick,4025135,42025135,38000000,6.4,2013,Riddick,
Movie 43,2840453,8840453,6000000,4.3,2013,Movie 43,
Her,2568251,25568251,23000000,8,2013,Her,
The Book Thief,2488481,21488481,19000000,7.6,2013,The Book Thief,
Inside Llewyn Davis,2235319,13235319,11000000,7.5,2013,Inside Llewyn Davis,
The Green Inferno,2192291,7192291,5000000,5.3,2013,The Green Inferno,
Side Effects,2172757,32172757,30000000,7.1,2013,Side Effects,
The To Do List,1991669,3491669,1500000,5.8,2013,The To Do List,
Kick-Ass 2,795985,28795985,28000000,6.5,2013,Kick-Ass 2,
Free Birds,750480,55750480,55000000,5.8,2013,Free Birds,
Upstream Color,394098,444098,50000,6.7,2013,Upstream Color,
Coherence,52617,102617,50000,7.2,2013,Coherence,
Cheap Thrills,-140576,59424,200000,6.7,2013,Cheap Thrills,
Blue Ruin,-161616,258384,420000,7.1,2013,Blue Ruin,
The Canyons,-193175,56825,250000,3.8,2013,The Canyons,
Prince Avalanche,-519861,205139,725000,6.3,2013,Prince Avalanche,
Locke,-624231,1375769,2000000,7.1,2013,Locke,
Homefront,-1841102,20158898,22000000,6.5,2013,Homefront,
The Bling Ring,-2154268,5845732,8000000,5.6,2013,The Bling Ring,
Bad Words,-2220386,7779614,10000000,6.6,2013,Bad Words,
Syrup,-2499337,663,2500000,5.7,2013,Syrup,
All Is Lost,-2736330,6263670,9000000,6.9,2013,All Is Lost,
Joe,-3626625,373375,4000000,6.9,2013,Joe,
Adult World,-3974632,25368,4000000,6.1,2013,Adult World,
The Sacrament,-3990779,9221,4000000,6.1,2013,The Sacrament,
Only God Forgives,-4020812,779188,4800000,5.7,2013,Only God Forgives,
The East,-4198161,2301839,6500000,6.8,2013,The East,
Labor Day,-4628472,13371528,18000000,6.9,2013,Labor Day,
Filth,-4965589,34411,5000000,7.1,2013,Filth,
Pawn Shop Chronicles,-4991912,8088,5000000,5.9,2013,Pawn Shop Chronicles,
Anna,-6995712,4288,7000000,6.5,2013,Anna,
The Incredible Burt Wonderstone,-7462119,22537881,30000000,5.9,2013,The Incredible Burt Wonderstone,
G.I. Joe: Retaliation,-7476940,122523060,130000000,5.8,2013,G.I. Joe: Retaliation,
Getaway,-7498062,10501938,18000000,4.4,2013,Getaway,
The Counselor,-8026285,16973715,25000000,5.3,2013,The Counselor,
The Zero Theorem,-8242294,257706,8500000,6.1,2013,The Zero Theorem,
Welcome to the Punch,-8490253,9747,8500000,6.1,2013,Welcome to the Punch,
Closed Circuit,-9249599,5750401,15000000,6.2,2013,Closed Circuit,
Parkland,-9346349,653651,10000000,6.4,2013,Parkland,
Lovelace,-9643418,356582,10000000,6.2,2013,Lovelace,
Grudge Match,-10192740,29807260,40000000,6.4,2013,Grudge Match,
Stoker,-10285779,1714221,12000000,6.8,2013,Stoker,
Out of the Furnace,-10669151,11330849,22000000,6.8,2013,Out of the Furnace,
Runner Runner,-10683354,19316646,30000000,5.6,2013,Runner Runner,
Under the Skin,-10685749,2614251,13300000,6.3,2013,Under the Skin,
Rush,-11052376,26947624,38000000,8.1,2013,Rush,
Life of Crime,-11734548,265452,12000000,5.8,2013,Life of Crime,
Machete Kills,-11991839,8008161,20000000,5.6,2013,Machete Kills,
The Big Wedding,-13180652,21819348,35000000,5.6,2013,The Big Wedding,
The Internship,-13327236,44672764,58000000,6.3,2013,The Internship,
The Host,-13372799,26627201,40000000,5.9,2013,The Host,
The Immigrant,-13974672,2025328,16000000,6.6,2013,The Immigrant,
Gangster Squad,-13999097,46000903,60000000,6.7,2013,Gangster Squad,
Metallica Through the Never,-14580033,3419967,18000000,7.2,2013,Metallica Through the Never,
Broken City,-15298836,19701164,35000000,6.2,2013,Broken City,
Phantom,-16965411,1034589,18000000,5.9,2013,Phantom,
Parker,-17383359,17616641,35000000,6.2,2013,Parker,
Trance,-17671257,2328743,20000000,6.9,2013,Trance,
Dead Man Down,-19104705,10895295,30000000,6.5,2013,Dead Man Down,
Hummingbird,-19963105,36895,20000000,6.2,2013,Hummingbird,
Percy Jackson: Sea of Monsters,-21440446,68559554,90000000,5.8,2013,Percy Jackson: Sea of Monsters,
Elysium,-21949883,93050117,115000000,6.6,2013,Elysium,
A Good Day to Die Hard,-24650802,67349198,92000000,5.3,2013,A Good Day to Die Hard,
The Fifth Estate,-24744992,3255008,28000000,6.2,2013,The Fifth Estate,
Escape Plan,-24864035,25135965,50000000,6.7,2013,Escape Plan,
Blood Ties,-25457528,42472,25500000,6.5,2013,Blood Ties,
Third Person,-26978602,1021398,28000000,6.3,2013,Third Person,
Paranoia,-27611346,7388654,35000000,5.7,2013,Paranoia,
Oldboy,-27806342,2193658,30000000,5.7,2013,Oldboy,
The Mortal Instruments: City of Bones,-28834579,31165421,60000000,5.9,2013,The Mortal Instruments: City of Bones,
RED 2,-30737440,53262560,84000000,6.6,2013,RED 2,
Oblivion,-30892765,89107235,120000000,7,2013,Oblivion,
The Secret Life of Walter Mitty,-31763162,58236838,90000000,7.3,2013,The Secret Life of Walter Mitty,
The Last Stand,-32949701,12050299,45000000,6.3,2013,The Last Stand,
The Smurfs 2,-33982216,71017784,105000000,5.3,2013,The Smurfs 2,
Beautiful Creatures,-40547862,19452138,60000000,6.1,2013,Beautiful Creatures,
Walking with Dinosaurs 3D,-43923879,36076121,80000000,5.2,2013,Walking with Dinosaurs 3D,
Ender's Game,-48262809,61737191,110000000,6.6,2013,Ender's Game,
Turbo,-51971872,83028128,135000000,6.4,2013,Turbo,
After Earth,-69477903,60522097,130000000,4.8,2013,After Earth,
White House Down,-76896216,73103784,150000000,6.4,2013,White House Down,
Pacific Rim,-88197094,101802906,190000000,6.9,2013,Pacific Rim,
R.I.P.D.,-96381145,33618855,130000000,5.6,2013,R.I.P.D.,
The Lone Ranger,-125697885,89302115,215000000,6.4,2013,The Lone Ranger,
47 Ronin,-136637525,38362475,175000000,6.3,2013,47 Ronin,
American Sniper,291326372,350126372,58800000,7.3,2014,American Sniper,
The Hunger Games: Mockingjay - Part 1,212135885,337135885,125000000,6.6,2014,The Hunger Games: Mockingjay - Part 1,
The Lego Movie,197760692,257760692,60000000,7.7,2014,The Lego Movie,
Guardians of the Galaxy,163176600,333176600,170000000,8,2014,Guardians of the Galaxy,
22 Jump Street,141719337,191719337,50000000,7,2014,22 Jump Street,
Neighbors,132157400,150157400,18000000,6.3,2014,Neighbors,
The Fault in Our Stars,112872350,124872350,12000000,7.7,2014,The Fault in Our Stars,
Ride Along,109938200,134938200,25000000,6.2,2014,Ride Along,
Gone Girl,106767189,167767189,61000000,8.1,2014,Gone Girl,
Captain America: The Winter Soldier,89766572,259766572,170000000,7.7,2014,Captain America: The Winter Soldier,
Lucy,86663600,126663600,40000000,6.4,2014,Lucy,
Heaven Is for Real,79443253,91443253,12000000,5.8,2014,Heaven Is for Real,
Into the Woods,78002372,128002372,50000000,5.9,2014,Into the Woods,
Annabelle,77773813,84273813,6500000,5.4,2014,Annabelle,
The Imitation Game,77125683,91125683,14000000,8,2014,The Imitation Game,
The Maze Runner,68427862,102427862,34000000,6.8,2014,The Maze Runner,
Teenage Mutant Ninja Turtles,66204754,191204754,125000000,5.8,2014,Teenage Mutant Ninja Turtles,
Divergent,65947895,150947895,85000000,6.7,2014,Divergent,
Let's Be Cops,65390774,82390774,17000000,6.4,2014,Let's Be Cops,
Tammy,64525432,84525432,20000000,4.9,2014,Tammy,
The Purge: Anarchy,62962800,71962800,9000000,6.4,2014,The Purge: Anarchy,
Maleficent,61410378,241410378,180000000,7,2014,Maleficent,
God's Not Dead,58755732,60755732,2000000,4.7,2014,God's Not Dead,
Big Hero 6,57527828,222527828,165000000,7.8,2014,Big Hero 6,
Unbroken,50637895,115637895,65000000,7.2,2014,Unbroken,
Kingsman: The Secret Service,47261724,128261724,81000000,7.7,2014,Kingsman: The Secret Service,
The Equalizer,46530738,101530738,55000000,7.2,2014,The Equalizer,
Dumb and Dumber To,46208010,86208010,40000000,5.6,2014,Dumb and Dumber To,
Ouija,45856010,50856010,5000000,4.5,2014,Ouija,
The Other Woman,43911193,83911193,40000000,6,2014,The Other Woman,
Non-Stop,42168600,92168600,50000000,6.9,2014,Non-Stop,
Taken 3,41256424,89256424,48000000,6,2014,Taken 3,
Think Like a Man Too,41182182,65182182,24000000,5.8,2014,Think Like a Man Too,
Godzilla,40676069,200676069,160000000,6.4,2014,Godzilla,
If I Stay,39474843,50474843,11000000,6.7,2014,If I Stay,
No Good Deed,39343632,52543632,13200000,5.6,2014,No Good Deed,
"Alexander and the Terrible, Horrible, No Good, Very Bad Day",38954149,66954149,28000000,6.2,2014,"Alexander and the Terrible, Horrible, No Good, Very Bad Day",
Dawn of the Planet of the Apes,38545589,208545589,170000000,7.6,2014,Dawn of the Planet of the Apes,
Son of God,37700064,59700064,22000000,5.7,2014,Son of God,
About Last Night,36137684,48637684,12500000,6.1,2014,About Last Night,
Transformers: Age of Extinction,35439076,245439076,210000000,5.6,2014,Transformers: Age of Extinction,
The Grand Budapest Hotel,34301324,59301324,25000000,8.1,2014,The Grand Budapest Hotel,
X-Men: Days of Future Past,33921534,233921534,200000000,8,2014,X-Men: Days of Future Past,
The Hundred-Foot Journey,32240821,54240821,22000000,7.3,2014,The Hundred-Foot Journey,
Selma,32076908,52076908,20000000,7.5,2014,Selma,
How to Train Your Dragon 2,32002924,177002924,145000000,7.8,2014,How to Train Your Dragon 2,
Unfriended,31482090,32482090,1000000,5.5,2014,Unfriended,
St. Vincent,31137712,44137712,13000000,7.2,2014,St. Vincent,
Rio 2,28538435,131538435,103000000,6.3,2014,Rio 2,
Paranormal Activity: The Marked Ones,27462372,32462372,5000000,5,2014,Paranormal Activity: The Marked Ones,
Earth to Echo,25934842,38934842,13000000,5.8,2014,Earth to Echo,
Birdman or (The Unexpected Virtue of Ignorance),24340598,42340598,18000000,7.7,2014,Birdman or (The Unexpected Virtue of Ignorance),
Nightcrawler,23881217,32381217,8500000,7.9,2014,Nightcrawler,
John Wick,23037835,43037835,20000000,7.4,2014,John Wick,
Interstellar,23020017,188020017,165000000,8.6,2014,Interstellar,
Wild,22880356,37880356,15000000,7.1,2014,Wild,
The Nut Job,22251541,64251541,42000000,5.7,2014,The Nut Job,
Boyhood,21352281,25352281,4000000,7.9,2014,Boyhood,
Paddington,21271832,76271832,55000000,7.2,2014,Paddington,
Annie,20911262,85911262,65000000,5.3,2014,Annie,
The Theory of Everything,20893537,35893537,15000000,7.7,2014,The Theory of Everything,
Chef,20424003,31424003,11000000,7.3,2014,Chef,
The Giver,20090374,45090374,25000000,6.5,2014,The Giver,
That Awkward Moment,18068955,26068955,8000000,6.1,2014,That Awkward Moment,
Fury,17817906,85817906,68000000,7.6,2014,Fury,
"As Above, So Below",16321100,21321100,5000000,6.2,2014,"As Above, So Below",
When the Game Stands Tall,15127963,30127963,15000000,6.7,2014,When the Game Stands Tall,
This Is Where I Leave You,14496320,34296320,19800000,6.6,2014,This Is Where I Leave You,
Still Alice,13754371,18754371,5000000,7.5,2014,Still Alice,
It Follows,13674076,14674076,1000000,6.8,2014,It Follows,
A Haunted House 2,13329486,17329486,4000000,4.7,2014,A Haunted House 2,
Top Five,13317471,25317471,12000000,6.4,2014,Top Five,
Black or White,12571189,21571189,9000000,6.6,2014,Black or White,
Horrible Bosses 2,12445357,54445357,42000000,6.3,2014,Horrible Bosses 2,
Million Dollar Arm,11457627,36457627,25000000,7,2014,Million Dollar Arm,
The November Man,10018119,25018119,15000000,6.3,2014,The November Man,
Whiplash,9792000,13092000,3300000,8.5,2014,Whiplash,
Planes: Fire & Rescue,9165787,59165787,50000000,6,2014,Planes: Fire & Rescue,
Devil's Due,8821461,15821461,7000000,4.1,2014,Devil's Due,
The Gambler,8680992,33680992,25000000,6,2014,The Gambler,
The Monuments Men,8031620,78031620,70000000,6.1,2014,The Monuments Men,
Beyond the Lights,7618727,14618727,7000000,6.9,2014,Beyond the Lights,
Jersey Boys,7047013,47047013,40000000,6.8,2014,Jersey Boys,
Blended,6294610,46294610,40000000,6.5,2014,Blended,
Moms' Night Out,5429707,10429707,5000000,5.4,2014,Moms' Night Out,
The Hobbit: The Battle of the Five Armies,5119788,255119788,250000000,7.4,2014,The Hobbit: The Battle of the Five Armies,
Big Eyes,4482031,14482031,10000000,7,2014,Big Eyes,
Draft Day,3842237,28842237,25000000,6.8,2014,Draft Day,
Endless Love,3438250,23438250,20000000,6.3,2014,Endless Love,
A Million Ways to Die in the West,3139300,43139300,40000000,6.1,2014,A Million Ways to Die in the West,
The Amazing Spider-Man 2,2853933,202853933,200000000,6.6,2014,The Amazing Spider-Man 2,
3 Days to Kill,2697999,30697999,28000000,6.2,2014,3 Days to Kill,
Love & Mercy,2551031,12551031,10000000,7.4,2014,Love & Mercy,
Saving Christmas,2283970,2783970,500000,1.4,2014,Saving Christmas,
A Most Wanted Man,2237855,17237855,15000000,6.8,2014,A Most Wanted Man,
Muppets Most Wanted,1183113,51183113,50000000,6.4,2014,Muppets Most Wanted,
The Best of Me,766213,26766213,26000000,6.7,2014,The Best of Me,
Get on Up,703100,30703100,30000000,6.9,2014,Get on Up,
Deliver Us from Evil,577122,30577122,30000000,6.2,2014,Deliver Us from Evil,
The One I Love,413447,513447,100000,7.1,2014,The One I Love,
The Book of Life,151543,50151543,50000000,7.3,2014,The Book of Life,
God's Pocket,-830024,169976,1000000,6.1,2014,God's Pocket,
Camp X-Ray,-986698,13302,1000000,6.9,2014,Camp X-Ray,
Honeymoon,-990682,9318,1000000,5.7,2014,Honeymoon,
Tusk,-1173295,1826705,3000000,5.3,2014,Tusk,
Clown,-1444993,55007,1500000,5.7,2014,Clown,
Sex Tape,-1456527,38543473,40000000,5.1,2014,Sex Tape,
A Walk Among the Tombstones,-1692400,26307600,28000000,6.5,2014,A Walk Among the Tombstones,
Rosewater,-1871059,3128941,5000000,6.6,2014,Rosewater,
The Drop,-1875611,10724389,12600000,7.1,2014,The Drop,
Lost River,-1954569,45431,2000000,5.7,2014,Lost River,
Left Behind,-1980076,14019924,16000000,3.1,2014,Left Behind,
Life After Beth,-2311727,88273,2400000,5.6,2014,Life After Beth,
Into the Storm,-2397806,47602194,50000000,5.8,2014,Into the Storm,
Wish I Was Here,-2408701,3591299,6000000,6.7,2014,Wish I Was Here,
The Disappearance of Eleanor Rigby: Them,-2412226,587774,3000000,6.3,2014,The Disappearance of Eleanor Rigby: Them,
While We're Young,-2412515,7587485,10000000,6.3,2014,While We're Young,
Veronica Mars,-2677873,3322127,6000000,6.8,2014,Veronica Mars,
And So It Goes,-2839199,15160801,18000000,5.8,2014,And So It Goes,
The Judge,-2880612,47119388,50000000,7.4,2014,The Judge,
The Signal,-3399104,600896,4000000,6.1,2014,The Signal,
300: Rise of an Empire,-3419949,106580051,110000000,6.2,2014,300: Rise of an Empire,
The Pyramid,-3743667,2756333,6500000,4.6,2014,The Pyramid,
Laggies,-3933019,1066981,5000000,6.4,2014,Laggies,
13 Sins,-3986191,13809,4000000,6.3,2014,13 Sins,
The Guest,-4667110,332890,5000000,6.7,2014,The Guest,
Better Living Through Chemistry,-4924857,75143,5000000,6.3,2014,Better Living Through Chemistry,
Rudderless,-4941707,58293,5000000,7.5,2014,Rudderless,
Cake,-5048224,1951776,7000000,6.4,2014,Cake,
Infinitely Polar Bear,-5269345,1430655,6700000,7,2014,Infinitely Polar Bear,
Barefoot,-5984929,15071,6000000,6.6,2014,Barefoot,
Magic in the Moonlight,-6260674,10539326,16800000,6.5,2014,Magic in the Moonlight,
99 Homes,-6588073,1411927,8000000,7.1,2014,99 Homes,
Brick Mansions,-7603171,20396829,28000000,5.7,2014,Brick Mansions,
The Loft,-7997316,6002684,14000000,6.3,2014,The Loft,
The Boxtrolls,-9162695,50837305,60000000,6.8,2014,The Boxtrolls,
Jack Ryan: Shadow Recruit,-9422588,50577412,60000000,6.2,2014,Jack Ryan: Shadow Recruit,
The Rover,-10885577,1114423,12000000,6.4,2014,The Rover,
Inherent Vice,-11889025,8110975,20000000,6.7,2014,Inherent Vice,
Foxcatcher,-11903700,12096300,24000000,7,2014,Foxcatcher,
Night at the Museum: Secret of the Tomb,-13253379,113746621,127000000,6.2,2014,Night at the Museum: Secret of the Tomb,
The Homesman,-13570011,2429989,16000000,6.6,2014,The Homesman,
Dracula Untold,-13719645,56280355,70000000,6.3,2014,Dracula Untold,
A Most Violent Year,-14250866,5749134,20000000,7,2014,A Most Violent Year,
Maps to the Stars,-14649259,350741,15000000,6.2,2014,Maps to the Stars,
"Men, Women & Children",-15294092,705908,16000000,6.7,2014,"Men, Women & Children",
Pawn Sacrifice,-16563367,2436633,19000000,7,2014,Pawn Sacrifice,
The Good Lie,-17277791,2722209,20000000,7.4,2014,The Good Lie,
The Water Diviner,-18303359,4196641,22500000,7,2014,The Water Diviner,
Before I Go to Sleep,-18757543,3242457,22000000,6.3,2014,Before I Go to Sleep,
Vampire Academy,-22208021,7791979,30000000,5.5,2014,Vampire Academy,
Need for Speed,-22422364,43577636,66000000,6.4,2014,Need for Speed,
Noah,-23799956,101200044,125000000,5.7,2014,Noah,
Sabotage,-24491482,10508518,35000000,5.7,2014,Sabotage,
Hercules,-27311386,72688614,100000000,6,2014,Hercules,
Serena,-29823609,176391,30000000,5.4,2014,Serena,
Step Up All In,-30095616,14904384,45000000,6,2014,Step Up All In,
The Two Faces of January,-30492537,507463,31000000,6.2,2014,The Two Faces of January,
Mr. Peabody & Sherman,-33493570,111506430,145000000,6.8,2014,Mr. Peabody & Sherman,
The Interview,-37894825,6105175,44000000,6.5,2014,The Interview,
RoboCop,-41392993,58607007,100000000,6.1,2014,RoboCop,
"I, Frankenstein",-45924710,19075290,65000000,5.1,2014,"I, Frankenstein",
Winter's Tale,-47399769,12600231,60000000,6.2,2014,Winter's Tale,
Penguins of Madagascar,-48149089,83850911,132000000,6.7,2014,Penguins of Madagascar,
The Expendables 3,-50677456,39322544,90000000,6.1,2014,The Expendables 3,
The Legend of Hercules,-51151462,18848538,70000000,4.2,2014,The Legend of Hercules,
Sin City: A Dame to Kill For,-51242196,13757804,65000000,6.5,2014,Sin City: A Dame to Kill For,
Exodus: Gods and Kings,-74985487,65014513,140000000,6,2014,Exodus: Gods and Kings,
Pompeii,-76780252,23219748,100000000,5.5,2014,Pompeii,
Transcendence,-76977691,23022309,100000000,6.3,2014,Transcendence,
Seventh Son,-77776735,17223265,95000000,5.5,2014,Seventh Son,
Edge of Tomorrow,-77793744,100206256,178000000,7.9,2014,Edge of Tomorrow,
Star Wars: Episode VII - The Force Awakens,691662225,936662225,245000000,7.9,2015,Star Wars: Episode VII - The Force Awakens,
Jurassic World,502270625,652270625,150000000,7,2015,Jurassic World,
Minions,262045770,336045770,74000000,6.4,2015,Minions,
Avengers: Age of Ultron,209005868,459005868,250000000,7.3,2015,Avengers: Age of Ultron,
Inside Out,181921711,356921711,175000000,8.1,2015,Inside Out,
Fast & Furious 7,163007020,353007020,190000000,7.1,2015,Fast & Furious 7,
Pitch Perfect 2,155296230,184296230,29000000,6.4,2015,Pitch Perfect 2,
Straight Outta Compton,133197785,161197785,28000000,7.8,2015,Straight Outta Compton,
Fifty Shades of Grey,126167230,166167230,40000000,4.1,2015,Fifty Shades of Grey,
The Hunger Games: Mockingjay - Part 2,121723902,281723902,160000000,6.5,2015,The Hunger Games: Mockingjay - Part 2,
The Martian,120433663,228433663,108000000,8,2015,The Martian,
Cinderella,106151353,201151353,95000000,6.9,2015,Cinderella,
Daddy's Home,100357137,150357137,50000000,6.2,2015,Daddy's Home,
Hotel Transylvania 2,89700110,169700110,80000000,6.7,2015,Hotel Transylvania 2,
The SpongeBob Movie: Sponge Out of Water,88994032,162994032,74000000,6,2015,The SpongeBob Movie: Sponge Out of Water,
Trainwreck,75212700,110212700,35000000,6.2,2015,Trainwreck,
Creed,74767581,109767581,35000000,7.6,2015,Creed,
War Room,64790117,67790117,3000000,6.5,2015,War Room,
The Visit,60206105,65206105,5000000,6.2,2015,The Visit,
Sisters,57044645,87044645,30000000,6,2015,Sisters,
Magic Mike XXL,51213057,66013057,14800000,5.6,2015,Magic Mike XXL,
Get Hard,50411453,90411453,40000000,6,2015,Get Hard,
Ant-Man,50202163,180202163,130000000,7.3,2015,Ant-Man,
The Revenant,48637894,183637894,135000000,8,2015,The Revenant,
Spy,45825712,110825712,65000000,7,2015,Spy,
San Andreas,45190832,155190832,110000000,6.1,2015,San Andreas,
Mission: Impossible - Rogue Nation,45042377,195042377,150000000,7.4,2015,Mission: Impossible - Rogue Nation,
Home,42397510,177397510,135000000,6.6,2015,Home,
The Big Short,42259870,70259870,28000000,7.8,2015,The Big Short,
Insidious: Chapter 3,42218558,52218558,10000000,6.1,2015,Insidious: Chapter 3,
The Wedding Ringer,41460211,64460211,23000000,6.6,2015,The Wedding Ringer,
Paul Blart: Mall Cop 2,41038190,71038190,30000000,4.4,2015,Paul Blart: Mall Cop 2,
The Intern,40764672,75764672,35000000,7.1,2015,The Intern,
The Gift,38787265,43787265,5000000,7,2015,The Gift,
Bridge of Spies,32313754,72313754,40000000,7.6,2015,Bridge of Spies,
The Boy Next Door,31423380,35423380,4000000,4.7,2015,The Boy Next Door,
The Peanuts Movie,31178411,130178411,99000000,7.1,2015,The Peanuts Movie,
Vacation,27884188,58884188,31000000,6.1,2015,Vacation,
Krampus,27725475,42725475,15000000,6.1,2015,Krampus,
"McFarland, USA",27482410,44482410,17000000,7.4,2015,"McFarland, USA",
Brooklyn,27322743,38322743,11000000,7.5,2015,Brooklyn,
The Duff,25530343,34030343,8500000,6.5,2015,The Duff,
Spotlight,25055776,45055776,20000000,8.1,2015,Spotlight,
The Second Best Exotic Marigold Hotel,23078266,33078266,10000000,6.6,2015,The Second Best Exotic Marigold Hotel,
The Gallows,22664410,22764410,100000,4.2,2015,The Gallows,
Max,22656255,42656255,20000000,6.7,2015,Max,
The Lazarus Effect,22501570,25801570,3300000,5.2,2015,The Lazarus Effect,
Southpaw,22421953,52421953,30000000,7.4,2015,Southpaw,
Goosebumps,22080379,80080379,58000000,6.3,2015,Goosebumps,
A Walk in the Woods,21504281,29504281,8000000,6.3,2015,A Walk in the Woods,
The VVitch: A New-England Folktale,21138705,25138705,4000000,6.9,2015,The VVitch: A New-England Folktale,
Maze Runner: The Scorch Trials,20697192,81697192,61000000,6.3,2015,Maze Runner: The Scorch Trials,
Insurgent,20179072,130179072,110000000,6.2,2015,Insurgent,
Paper Towns,20000304,32000304,12000000,6.3,2015,Paper Towns,
The Night Before,18047372,43047372,25000000,6.4,2015,The Night Before,
Sinister 2,17740955,27740955,10000000,5.3,2015,Sinister 2,
The Age of Adaline,17629776,42629776,25000000,7.2,2015,The Age of Adaline,
Sicario,16889293,46889293,30000000,7.6,2015,Sicario,
Ted 2,13476385,81476385,68000000,6.3,2015,Ted 2,
"Hello, My Name Is Doris",13444999,14444999,1000000,6.6,2015,"Hello, My Name Is Doris",
Poltergeist,12425125,47425125,35000000,4.9,2015,Poltergeist,
No Escape,11088872,27288872,16200000,6.8,2015,No Escape,
Dope,10506470,17506470,7000000,7.2,2015,Dope,
Project Almanac,10348241,22348241,12000000,6.4,2015,Project Almanac,
The Hateful Eight,10117416,54117416,44000000,7.8,2015,The Hateful Eight,
Black Mass,9575678,62575678,53000000,6.9,2015,Black Mass,
Love the Coopers,9302731,26302731,17000000,5.8,2015,Love the Coopers,
Ricki and the Flash,8822144,26822144,18000000,5.9,2015,Ricki and the Flash,
Paranormal Activity: The Ghost Dimension,8300124,18300124,10000000,4.6,2015,Paranormal Activity: The Ghost Dimension,
Hardcore Henry,7252038,9252038,2000000,6.7,2015,Hardcore Henry,
Mr. Holmes,6737646,17737646,11000000,6.9,2015,Mr. Holmes,
Grandma,6380524,6980524,600000,6.7,2015,Grandma,
Focus,3762963,53862963,50100000,6.6,2015,Focus,
The Longest Ride,3446117,37446117,34000000,7.1,2015,The Longest Ride,
Entourage,2363404,32363404,30000000,6.6,2015,Entourage,
Room,1677654,14677654,13000000,8.1,2015,Room,
We Are Your Friends,1591417,3591417,2000000,6.2,2015,We Are Your Friends,
The Meddler,1067218,4267218,3200000,6.3,2015,The Meddler,
Carol,911491,12711491,11800000,7.2,2015,Carol,
Secret in Their Eyes,680155,20180155,19500000,6.3,2015,Secret in Their Eyes,
Tangerine,602354,702354,100000,7.1,2015,Tangerine,
Hot Pursuit,-419799,34580201,35000000,5.1,2015,Hot Pursuit,
Concussion,-457526,34542474,35000000,7.1,2015,Concussion,
The Diary of a Teenage Girl,-522998,1477002,2000000,6.9,2015,The Diary of a Teenage Girl,
Cop Car,-665448,134552,800000,6.3,2015,Cop Car,
Me and Earl and the Dying Girl,-1241584,6758416,8000000,7.7,2015,Me and Earl and the Dying Girl,
Hot Tub Time Machine 2,-1685349,12314651,14000000,5.1,2015,Hot Tub Time Machine 2,
Green Room,-1779629,3220371,5000000,7,2015,Green Room,
The D Train,-2326849,673151,3000000,5,2015,The D Train,
Knock Knock,-2463664,36336,2500000,4.9,2015,Knock Knock,
Joy,-3548768,56451232,60000000,6.6,2015,Joy,
The Danish Girl,-3885982,11114018,15000000,7.1,2015,The Danish Girl,
Alvin and the Chipmunks: The Road Chip,-4113013,85886987,90000000,5,2015,Alvin and the Chipmunks: The Road Chip,
Anomalisa,-4240714,3759286,8000000,7.3,2015,Anomalisa,
Danny Collins,-4362934,5637066,10000000,7,2015,Danny Collins,
Area 51,-4992444,7556,5000000,4.2,2015,Area 51,
Mississippi Grind,-5869459,130541,6000000,6.4,2015,Mississippi Grind,
Beasts of No Nation,-5909223,90777,6000000,7.7,2015,Beasts of No Nation,
The Man Who Knew Infinity,-6133206,3866794,10000000,7.2,2015,The Man Who Knew Infinity,
The Vatican Tapes,-6215237,1784763,8000000,4.8,2015,The Vatican Tapes,
Burnt,-6348054,13651946,20000000,6.6,2015,Burnt,
Freeheld,-6426665,573335,7000000,6.6,2015,Freeheld,
Irrational Man,-6969640,4030360,11000000,6.6,2015,Irrational Man,
Truth,-7058146,2541854,9600000,6.8,2015,Truth,
Trumbo,-7142259,7857741,15000000,7.5,2015,Trumbo,
Eddie the Eagle,-7210611,15789389,23000000,7.4,2015,Eddie the Eagle,
Z for Zachariah,-7378539,121461,7500000,6,2015,Z for Zachariah,
Mr. Right,-7965306,34694,8000000,6.3,2015,Mr. Right,
Demolition,-8021408,1978592,10000000,7,2015,Demolition,
Heist,-8849864,50136,8900000,6.1,2015,Heist,
Pixels,-9252415,78747585,88000000,5.5,2015,Pixels,
By the Sea,-9461540,538460,10000000,5.3,2015,By the Sea,
Louder Than Bombs,-10836193,163807,11000000,6.6,2015,Louder Than Bombs,
Scouts Guide to the Zombie Apocalypse,-11296954,3703046,15000000,6.3,2015,Scouts Guide to the Zombie Apocalypse,
Everest,-11517730,43482270,55000000,7.1,2015,Everest,
Rock the Kasbah,-11979336,3020664,15000000,5.5,2015,Rock the Kasbah,
Steve Jobs,-12233342,17766658,30000000,7.2,2015,Steve Jobs,
Hitman: Agent 47,-12532550,22467450,35000000,5.7,2015,Hitman: Agent 47,
Little Boy,-13514039,6485961,20000000,7.4,2015,Little Boy,
American Ultra,-13559015,14440985,28000000,6.1,2015,American Ultra,
Self/less,-13720309,12279691,26000000,6.5,2015,Self/less,
The 33,-13772278,12227722,26000000,6.9,2015,The 33,
Macbeth,-13889293,1110707,15000000,6.6,2015,Macbeth,
Colonia,-13984291,15709,14000000,7.1,2015,Colonia,
Barely Lethal,-14993925,6075,15000000,5.4,2015,Barely Lethal,
Aloha,-15932884,21067116,37000000,5.4,2015,Aloha,
Equals,-15966742,33258,16000000,6.1,2015,Equals,
Chappie,-17430732,31569268,49000000,6.8,2015,Chappie,
Dark Places,-19791412,208588,20000000,6.2,2015,Dark Places,
Our Brand Is Crisis,-20997739,7002261,28000000,6.1,2015,Our Brand Is Crisis,
Jane Got a Gun,-23486207,1513793,25000000,5.9,2015,Jane Got a Gun,
Run All Night,-23538356,26461644,50000000,6.6,2015,Run All Night,
Crimson Peak,-23909680,31090320,55000000,6.5,2015,Crimson Peak,
Unfinished Business,-24780499,10219501,35000000,5.4,2015,Unfinished Business,
The Walk,-24862498,10137502,35000000,7.3,2015,The Walk,
The Sea of Trees,-24979556,20444,25000000,6.1,2015,The Sea of Trees,
Legend,-28127006,1872994,30000000,6.9,2015,Legend,
The Gunman,-29335251,10664749,40000000,5.8,2015,The Gunman,
Bilal: A New Breed of Hero,-29509027,490973,30000000,7.9,2015,Bilal: A New Breed of Hero,
The Man from U.N.C.L.E.,-29554891,45445109,75000000,7.3,2015,The Man from U.N.C.L.E.,
Spectre,-44925391,200074609,245000000,6.8,2015,Spectre,
Child 44,-48775670,1224330,50000000,6.5,2015,Child 44,
Mortdecai,-52303866,7696134,60000000,5.5,2015,Mortdecai,
Victor Frankenstein,-59224924,5775076,65000000,6,2015,Victor Frankenstein,
Blackhat,-61994020,8005980,70000000,5.4,2015,Blackhat,
The Last Witch Hunter,-62632340,27367660,90000000,6,2015,The Last Witch Hunter,
Fantastic Four,-63882452,56117548,120000000,4.3,2015,Fantastic Four,
Terminator Genisys,-65239044,89760956,155000000,6.3,2015,Terminator Genisys,
In the Heart of the Sea,-74979242,25020758,100000000,6.9,2015,In the Heart of the Sea,
Point Break,-76217519,28782481,105000000,5.3,2015,Point Break,
The Good Dinosaur,-76912880,123087120,200000000,6.7,2015,The Good Dinosaur,
Le Petit Prince,-79860848,1339152,81200000,7.7,2015,Le Petit Prince,
Tomorrowland,-96563678,93436322,190000000,6.4,2015,Tomorrowland,
Pan,-114911680,35088320,150000000,5.7,2015,Pan,
Jupiter Ascending,-128612277,47387723,176000000,5.3,2015,Jupiter Ascending,
Rogue One,332177324,532177324,200000000,7.8,2016,Rogue One,
Deadpool,305070709,363070709,58000000,8,2016,Deadpool,
The Secret Life of Pets,293384330,368384330,75000000,6.5,2016,The Secret Life of Pets,
Finding Dory,286295561,486295561,200000000,7.3,2016,Finding Dory,
Sing,195395425,270395425,75000000,7.1,2016,Sing,
Zootopia,191268248,341268248,150000000,8,2016,Zootopia,
The Jungle Book,189001123,364001123,175000000,7.4,2016,The Jungle Book,
Captain America: Civil War,158084349,408084349,250000000,7.8,2016,Captain America: Civil War,
Suicide Squad,150100054,325100054,175000000,6,2016,Suicide Squad,
Hidden Figures,144607287,169607287,25000000,7.8,2016,Hidden Figures,
Split,129291365,138291365,9000000,7.3,2016,Split,
La La Land,121101803,151101803,30000000,8,2016,La La Land,
Moana,98757044,248757044,150000000,7.6,2016,Moana,
Bad Moms,93257297,113257297,20000000,6.2,2016,Bad Moms,
Batman v Superman: Dawn of Justice,80360194,330360194,250000000,6.4,2016,Batman v Superman: Dawn of Justice,
Don't Breathe,79317875,89217875,9900000,7.1,2016,Don't Breathe,
Sausage Party,78685686,97685686,19000000,6.1,2016,Sausage Party,
Central Intelligence,77440871,127440871,50000000,6.3,2016,Central Intelligence,
The Purge: Election Year,69213375,79213375,10000000,6,2016,The Purge: Election Year,
Doctor Strange,67641920,232641920,165000000,7.5,2016,Doctor Strange,
Sully,65070033,125070033,60000000,7.4,2016,Sully,
The Conjuring 2,62470008,102470008,40000000,7.3,2016,The Conjuring 2,
Lights Out,62368835,67268835,4900000,6.3,2016,Lights Out,
10 Cloverfield Lane,57082998,72082998,15000000,7.2,2016,10 Cloverfield Lane,
Fantastic Beasts and Where to Find Them,54037575,234037575,180000000,7.3,2016,Fantastic Beasts and Where to Find Them,
Arrival,53546139,100546139,47000000,7.9,2016,Arrival,
Ride Along 2,51221830,91221830,40000000,5.9,2016,Ride Along 2,
Miracles from Heaven,48705123,61705123,13000000,7.1,2016,Miracles from Heaven,
Jason Bourne,42434410,162434410,120000000,6.6,2016,Jason Bourne,
The Accountant,42260045,86260045,44000000,7.3,2016,The Accountant,
My Big Fat Greek Wedding 2,41689605,59689605,18000000,6,2016,My Big Fat Greek Wedding 2,
Lion,39738905,51738905,12000000,8,2016,Lion,
Manchester by the Sea,38695371,47695371,9000000,7.8,2016,Manchester by the Sea,
The Shallows,38124043,55124043,17000000,6.3,2016,The Shallows,
Me Before You,36245075,56245075,20000000,7.4,2016,Me Before You,
Angry Birds,34509366,107509366,73000000,6.3,2016,Angry Birds,
The Boss,34285885,63285885,29000000,5.4,2016,The Boss,
Barbershop: The Next Cut,34030051,54030051,20000000,5.9,2016,Barbershop: The Next Cut,
Fences,33682904,57682904,24000000,7.2,2016,Fences,
The Girl on the Train,30395035,75395035,45000000,6.5,2016,The Girl on the Train,
Trolls,28707064,153707064,125000000,6.5,2016,Trolls,
Hacksaw Ridge,27209615,67209615,40000000,8.1,2016,Hacksaw Ridge,
Ouija: Origin of Evil,26144505,35144505,9000000,6.1,2016,Ouija: Origin of Evil,
The Boy,25819556,35819556,10000000,6,2016,The Boy,
Moonlight,23854932,27854932,4000000,7.4,2016,Moonlight,
Why Him?,22323786,60323786,38000000,6.2,2016,Why Him?,
Neighbors 2: Sorority Rising,20455765,55455765,35000000,5.7,2016,Neighbors 2: Sorority Rising,
Nerve,19583626,38583626,19000000,6.5,2016,Nerve,
Risen,16880033,36880033,20000000,6.3,2016,Risen,
The Forest,16594261,26594261,10000000,4.8,2016,The Forest,
Blair Witch,15777061,20777061,5000000,5,2016,Blair Witch,
God's Not Dead 2,15774575,20774575,5000000,4.4,2016,God's Not Dead 2,
Hell or High Water,15007844,27007844,12000000,7.6,2016,Hell or High Water,
Money Monster,14012075,41012075,27000000,6.5,2016,Money Monster,
Mike and Dave Need Wedding Dates,13009673,46009673,33000000,6,2016,Mike and Dave Need Wedding Dates,
Pete's Dragon,11233151,76233151,65000000,6.7,2016,Pete's Dragon,
Dirty Grandpa,10593113,35593113,25000000,5.9,2016,Dirty Grandpa,
Office Christmas Party,9767494,54767494,45000000,5.8,2016,Office Christmas Party,
How to Be Single,8843513,46843513,38000000,6.1,2016,How to Be Single,
"Hail, Caesar!",8498085,30498085,22000000,6.3,2016,"Hail, Caesar!",
Meet the Blacks,8197072,9097072,900000,4.8,2016,Meet the Blacks,
Mother's Day,7492859,32492859,25000000,5.7,2016,Mother's Day,
The Birth of a Nation,7361566,15861566,8500000,6.4,2016,The Birth of a Nation,
The Darkness,6753574,10753574,4000000,4.4,2016,The Darkness,
Fifty Shades of Black,6686940,11686940,5000000,3.5,2016,Fifty Shades of Black,
Keanu,5591853,20591853,15000000,6.2,2016,Keanu,
The Edge of Seventeen,5431633,14431633,9000000,7.3,2016,The Edge of Seventeen,
The Belko Experiment,5166820,10166820,5000000,6.1,2016,The Belko Experiment,
Jackie,4960394,13960394,9000000,6.7,2016,Jackie,
The Magnificent Seven,3432655,93432655,90000000,6.9,2016,The Magnificent Seven,
War Dogs,3034523,43034523,40000000,7.1,2016,War Dogs,
13 Hours,2853219,52853219,50000000,7.3,2016,13 Hours,
Storks,2679278,72679278,70000000,6.8,2016,Storks,
London Has Fallen,2524260,62524260,60000000,5.9,2016,London Has Fallen,
Swiss Army Man,1210454,4210454,3000000,7,2016,Swiss Army Man,
Batman: The Killing Joke,275000,3775000,3500000,6.4,2016,Batman: The Killing Joke,
Incarnate,-200226,4799774,5000000,5.3,2016,Incarnate,
31,-720180,779820,1500000,5.1,2016,31,
Bleed for This,-916094,5083906,6000000,6.8,2016,Bleed for This,
Loving,-1248031,7751969,9000000,7,2016,Loving,
Jack Reacher: Never Go Back,-1302924,58697076,60000000,6.1,2016,Jack Reacher: Never Go Back,
20th Century Women,-1335236,5664764,7000000,7.3,2016,20th Century Women,
Kung Fu Panda 3,-1471381,143528619,145000000,7.1,2016,Kung Fu Panda 3,
Beta Test,-1589896,10104,1600000,5.7,2016,Beta Test,
The Hollars,-2783015,1016985,3800000,6.5,2016,The Hollars,
Paterson,-2847262,2152738,5000000,7.4,2016,Paterson,
The 5th Wave,-3083213,34916787,38000000,5.2,2016,The 5th Wave,
Shut In,-3099665,6900335,10000000,4.8,2016,Shut In,
Morgan,-4084749,3915251,8000000,5.8,2016,Morgan,
Underworld: Blood Wars,-4646027,30353973,35000000,5.8,2016,Underworld: Blood Wars,
Collateral Beauty,-4983979,31016021,36000000,6.8,2016,Collateral Beauty,
The Neon Demon,-5666876,1333124,7000000,6.2,2016,The Neon Demon,
The Bad Batch,-5819149,180851,6000000,5.3,2016,The Bad Batch,
Denial,-5926511,4073489,10000000,6.7,2016,Denial,
Queen of Katwe,-6125611,8874389,15000000,7.4,2016,Queen of Katwe,
Max Steel,-6181336,3818664,10000000,4.6,2016,Max Steel,
Everybody Wants Some!!,-6599722,3400278,10000000,6.9,2016,Everybody Wants Some!!,
Mr. Church,-7314220,685780,8000000,7.6,2016,Mr. Church,
Triple 9,-7360703,12639297,20000000,6.3,2016,Triple 9,
The Light Between Oceans,-7454021,12545979,20000000,7.2,2016,The Light Between Oceans,
Masterminds,-7631978,17368022,25000000,5.8,2016,Masterminds,
Bad Santa 2,-8217822,17782178,26000000,5.6,2016,Bad Santa 2,
Miss Sloane,-9499395,3500605,13000000,7.5,2016,Miss Sloane,
Passengers,-9985301,100014699,110000000,7,2016,Passengers,
Popstar: Never Stop Never Stopping,-10360875,9639125,20000000,6.7,2016,Popstar: Never Stop Never Stopping,
Bridget Jones's Baby,-10747580,24252420,35000000,6.5,2016,Bridget Jones's Baby,
Nocturnal Animals,-11836643,10663357,22500000,7.5,2016,Nocturnal Animals,
Whiskey Tango Foxtrot,-11916666,23083334,35000000,6.6,2016,Whiskey Tango Foxtrot,
Colossal,-11970713,3029287,15000000,6.2,2016,Colossal,
Kubo and the Two Strings,-11976912,48023088,60000000,7.8,2016,Kubo and the Two Strings,
The Founder,-12213947,12786053,25000000,7.2,2016,The Founder,
The Infiltrator,-12563192,15436808,28000000,7,2016,The Infiltrator,
Gold,-12772962,7227038,20000000,6.7,2016,Gold,
Patriots Day,-13113639,31886361,45000000,7.4,2016,Patriots Day,
Resident Evil: The Final Chapter,-13169932,26830068,40000000,5.5,2016,Resident Evil: The Final Chapter,
The Nice Guys,-13738237,36261763,50000000,7.4,2016,The Nice Guys,
Midnight Special,-14287718,3712282,18000000,6.6,2016,Midnight Special,
Hands of Stone,-15287208,4712792,20000000,6.6,2016,Hands of Stone,
Ghostbusters,-15649426,128350574,144000000,5.2,2016,Ghostbusters,
Criminal,-16791304,14708696,31500000,6.3,2016,Criminal,
Pride and Prejudice and Zombies,-17061866,10938134,28000000,5.8,2016,Pride and Prejudice and Zombies,
Snowden,-18412481,21587519,40000000,7.3,2016,Snowden,
Mechanic: Resurrection,-18781597,21218403,40000000,5.7,2016,Mechanic: Resurrection,
Caf√© Society,-18896795,11103205,30000000,6.6,2016,Caf√© Society,
Collide,-19219996,2280004,21500000,5.7,2016,Collide,
Bastille Day,-19949731,50269,20000000,6.3,2016,Bastille Day,
Zoolander 2,-21151307,28848693,50000000,4.7,2016,Zoolander 2,
The Lost City of Z,-21419590,8580410,30000000,6.6,2016,The Lost City of Z,
X-Men: Apocalypse,-22557511,155442489,178000000,6.9,2016,X-Men: Apocalypse,
Miss Peregrine's Home for Peculiar Children,-22757166,87242834,110000000,6.7,2016,Miss Peregrine's Home for Peculiar Children,
Now You See Me 2,-24924460,65075540,90000000,6.5,2016,Now You See Me 2,
Keeping Up with the Joneses,-25095574,14904426,40000000,5.9,2016,Keeping Up with the Joneses,
A Hologram for the King,-25787506,4212494,30000000,6.1,2016,A Hologram for the King,
Star Trek Beyond,-26151660,158848340,185000000,7.1,2016,Star Trek Beyond,
Grimsby,-28125163,6874837,35000000,6.2,2016,Grimsby,
Free State of Jones,-29189964,20810036,50000000,6.9,2016,Free State of Jones,
All I See Is You,-29782356,217644,30000000,5.4,2016,All I See Is You,
A Cure for Wellness,-31893014,8106986,40000000,6.4,2016,A Cure for Wellness,
Billy Lynn's Long Halftime Walk,-38261523,1738477,40000000,6.2,2016,Billy Lynn's Long Halftime Walk,
Silence,-38899823,7100177,46000000,7.2,2016,Silence,
A Monster Calls,-39259177,3740823,43000000,7.5,2016,A Monster Calls,
Inferno,-40656426,34343574,75000000,6.2,2016,Inferno,
Ice Age: Collision Course,-40936992,64063008,105000000,5.7,2016,Ice Age: Collision Course,
Allegiant,-43815949,66184051,110000000,5.7,2016,Allegiant,
Allied,-44901936,40098064,85000000,7.1,2016,Allied,
Deepwater Horizon,-48566473,61433527,110000000,7.1,2016,Deepwater Horizon,
The Finest Hours,-52430442,27569558,80000000,6.8,2016,The Finest Hours,
Teenage Mutant Ninja Turtles: Out of the Shadows,-52948399,82051601,135000000,6,2016,Teenage Mutant Ninja Turtles: Out of the Shadows,
The Legend of Tarzan,-53356939,126643061,180000000,6.2,2016,The Legend of Tarzan,
Independence Day: Resurgence,-61855714,103144286,165000000,5.2,2016,Independence Day: Resurgence,
The Huntsman: Winter's War,-66609810,48390190,115000000,6.1,2016,The Huntsman: Winter's War,
Assassin's Creed,-70352052,54647948,125000000,5.7,2016,Assassin's Creed,
Ben-Hur,-73589523,26410477,100000000,5.7,2016,Ben-Hur,
The Promise,-81775712,8224288,90000000,6,2016,The Promise,
The BFG,-84516230,55483770,140000000,6.4,2016,The BFG,
Alice Through the Looking Glass,-92958619,77041381,170000000,6.2,2016,Alice Through the Looking Glass,
Live by Night,-97621445,10378555,108000000,6.4,2016,Live by Night,
The Great Wall,-104459170,45540830,150000000,5.9,2016,The Great Wall,
Gods of Egypt,-108846536,31153464,140000000,5.4,2016,Gods of Egypt,
Warcraft,-112634710,47365290,160000000,6.8,2016,Warcraft,
Beauty and the Beast,344481165,504481165,160000000,7.1,2017,Beauty and the Beast,
Jumanji: Welcome to the Jungle,314540171,404540171,90000000,6.9,2017,Jumanji: Welcome to the Jungle,
Star Wars: Episode VIII - The Last Jedi,303181382,620181382,317000000,7,2017,Star Wars: Episode VIII - The Last Jedi,
It,293828874,328828874,35000000,7.3,2017,It,
Wonder Woman,263563408,412563408,149000000,7.4,2017,Wonder Woman,
Guardians of the Galaxy Vol. 2,189813101,389813101,200000000,7.6,2017,Guardians of the Galaxy Vol. 2,
Despicable Me 3,184624300,264624300,80000000,6.3,2017,Despicable Me 3,
Get Out,171540665,176040665,4500000,7.7,2017,Get Out,
Spider-Man: Homecoming,159201140,334201140,175000000,7.4,2017,Spider-Man: Homecoming,
Thor: Ragnarok,135058289,315058289,180000000,7.9,2017,Thor: Ragnarok,
Logan,129277068,226277068,97000000,8.1,2017,Logan,
Wonder,112422809,132422809,20000000,8,2017,Wonder,
Girls Trip,96171585,115171585,19000000,6.2,2017,Girls Trip,
The Lego Batman Movie,95750384,175750384,80000000,7.3,2017,The Lego Batman Movie,
The Greatest Showman,90340174,174340174,84000000,7.6,2017,The Greatest Showman,
Dunkirk,89740665,189740665,100000000,7.9,2017,Dunkirk,
Annabelle: Creation,87092201,102092201,15000000,6.5,2017,Annabelle: Creation,
Baby Driver,73825862,107825862,34000000,7.6,2017,Baby Driver,
The Upside,70752517,108252517,37500000,6.9,2017,The Upside,
Pitch Perfect 3,59897530,104897530,45000000,5.8,2017,Pitch Perfect 3,
Fifty Shades Darker,59581250,114581250,55000000,4.6,2017,Fifty Shades Darker,
John Wick: Chapter 2,52029184,92029184,40000000,7.5,2017,John Wick: Chapter 2,
Happy Death Day,50883845,55683845,4800000,6.6,2017,Happy Death Day,
The Boss Baby,50003033,175003033,125000000,6.3,2017,The Boss Baby,
Murder on the Orient Express,47826543,102826543,55000000,6.5,2017,Murder on the Orient Express,
The Hitman's Bodyguard,45468583,75468583,30000000,6.9,2017,The Hitman's Bodyguard,
The Shape of Water,44459435,63859435,19400000,7.3,2017,The Shape of Water,
A Bad Moms Christmas,44110659,72110659,28000000,5.6,2017,A Bad Moms Christmas,
A Dog's Purpose,42508620,64508620,22000000,7.2,2017,A Dog's Purpose,
"Three Billboards Outside Ebbing, Missouri",39513740,54513740,15000000,8.2,2017,"Three Billboards Outside Ebbing, Missouri",
Lady Bird,38958273,48958273,10000000,7.4,2017,Lady Bird,
The Big Sick,37873127,42873127,5000000,7.5,2017,The Big Sick,
The Shack,37386418,57386418,20000000,6.3,2017,The Shack,
The Emoji Movie,36089513,86089513,50000000,3.3,2017,The Emoji Movie,
Captain Underpants: The First Epic Movie,35921000,73921000,38000000,6.2,2017,Captain Underpants: The First Epic Movie,
Daddy's Home 2,35029443,104029443,69000000,6,2017,Daddy's Home 2,
Coco,34726015,209726015,175000000,8.4,2017,Coco,
The Post,31903458,81903458,50000000,7.2,2017,The Post,
Jigsaw,28052832,38052832,10000000,5.8,2017,Jigsaw,
Darkest Hour,26468410,56468410,30000000,7.4,2017,Darkest Hour,
"Everything, Everything",24121140,34121140,10000000,6.4,2017,"Everything, Everything",
Wind River,22800859,33800859,11000000,7.7,2017,Wind River,
How to Be a Latin Lover,22149404,32149404,10000000,6,2017,How to Be a Latin Lover,
Atomic Blonde,21687870,51687870,30000000,6.7,2017,Atomic Blonde,
Going in Style,20018541,45018541,25000000,6.6,2017,Going in Style,
"I, Tonya",19014539,30014539,11000000,7.5,2017,"I, Tonya",
Gifted,17801212,24801212,7000000,7.6,2017,Gifted,
Home Again,15020284,27020284,12000000,5.8,2017,Home Again,
The Bye Bye Man,14995806,22395806,7400000,4.2,2017,The Bye Bye Man,
The Disaster Artist,11120616,21120616,10000000,7.4,2017,The Disaster Artist,
Fist Fight,10187017,32187017,22000000,5.6,2017,Fist Fight,
Kidnap,9971040,30971040,21000000,5.9,2017,Kidnap,
It Comes at Night,8985117,13985117,5000000,6.2,2017,It Comes at Night,
The Glass Castle,8273059,17273059,9000000,7.1,2017,The Glass Castle,
Before I Fall,7241122,12241122,5000000,6.4,2017,Before I Fall,
All Eyez on Me,4922302,44922302,40000000,5.8,2017,All Eyez on Me,
Chappaquiddick,4395520,17395520,13000000,6.5,2017,Chappaquiddick,
The Florida Project,3904366,5904366,2000000,7.6,2017,The Florida Project,
Snatched,3852178,45852178,42000000,4.5,2017,Snatched,
American Assassin,3249674,36249674,33000000,6.2,2017,American Assassin,
Rings,2793018,27793018,25000000,4.5,2017,Rings,
The Circle,2497844,20497844,18000000,5.3,2017,The Circle,
Wish Upon,2301505,14301505,12000000,5,2017,Wish Upon,
Rough Night,2105643,22105643,20000000,5.2,2017,Rough Night,
A Ghost Story,1496371,1596371,100000,6.9,2017,A Ghost Story,
American Made,1342000,51342000,50000000,7.2,2017,American Made,
Paddington 2,891591,40891591,40000000,7.8,2017,Paddington 2,
The Beguiled,209995,10709995,10500000,6.3,2017,The Beguiled,
The Foreigner,-606493,34393507,35000000,7,2017,The Foreigner,
Unforgettable,-631988,11368012,12000000,5.1,2017,Unforgettable,
Logan Lucky,-1219023,27780977,29000000,7,2017,Logan Lucky,
Molly's Game,-1219256,28780744,30000000,7.4,2017,Molly's Game,
Table 19,-1385104,3614896,5000000,5.8,2017,Table 19,
Marshall,-1948341,10051659,12000000,7.2,2017,Marshall,
Flatliners,-2116885,16883115,19000000,5.2,2017,Flatliners,
The Zookeeper's Wife,-2428340,17571660,20000000,7,2017,The Zookeeper's Wife,
Good Time,-2473501,2026499,4500000,7.4,2017,Good Time,
Disobedience,-2501218,3498782,6000000,6.6,2017,Disobedience,
Thoroughbreds,-2927395,3072605,6000000,6.7,2017,Thoroughbreds,
War for the Planet of the Apes,-3119838,146880162,150000000,7.4,2017,War for the Planet of the Apes,
Kingsman: The Golden Circle,-3765162,100234838,104000000,6.7,2017,Kingsman: The Golden Circle,
The Mountain Between Us,-4651445,30348555,35000000,6.4,2017,The Mountain Between Us,
The Death of Stalin,-4952144,8047856,13000000,7.2,2017,The Death of Stalin,
The Vault,-4994272,5728,5000000,4.8,2017,The Vault,
The Book of Henry,-5495026,4504974,10000000,6.6,2017,The Book of Henry,
CHIPS,-6399848,18600152,25000000,6,2017,CHIPS,
Father Figures,-7498756,17501244,25000000,5.5,2017,Father Figures,
Hostiles,-9180886,29819114,39000000,7.2,2017,Hostiles,
Sleepless,-9216296,20783704,30000000,5.6,2017,Sleepless,
The Dark Tower,-9298675,50701325,60000000,5.6,2017,The Dark Tower,
"Roman J. Israel, Esq.",-10037222,11962778,22000000,6.5,2017,"Roman J. Israel, Esq.",
Thank You for Your Service,-10463700,9536300,20000000,6.5,2017,Thank You for Your Service,
The Lego Ninjago Movie,-10718445,59281555,70000000,6,2017,The Lego Ninjago Movie,
Baywatch,-10939814,58060186,69000000,5.5,2017,Baywatch,
Mother!,-12199996,17800004,30000000,6.6,2017,Mother!,
Battle of the Sexes,-12361474,12638526,25000000,6.7,2017,Battle of the Sexes,
Phantom Thread,-13801795,21198205,35000000,7.5,2017,Phantom Thread,
The House,-14415496,25584504,40000000,5.6,2017,The House,
Power Rangers,-14635550,85364450,100000000,5.9,2017,Power Rangers,
Smurfs: The Lost Village,-14979718,45020282,60000000,6,2017,Smurfs: The Lost Village,
Kong: Skull Island,-16947188,168052812,185000000,6.6,2017,Kong: Skull Island,
Detroit,-17209861,16790139,34000000,7.3,2017,Detroit,
Suburbicon,-19224822,5775178,25000000,5.7,2017,Suburbicon,
Only the Brave,-19656017,18343983,38000000,7.6,2017,Only the Brave,
Cars 3,-22098885,152901115,175000000,6.7,2017,Cars 3,
The Space Between Us,-22114706,7885294,30000000,6.4,2017,The Space Between Us,
Tulip Fever,-22544365,2455635,25000000,6.2,2017,Tulip Fever,
Alien: Covenant,-22737969,74262031,97000000,6.4,2017,Alien: Covenant,
Wonder Wheel,-23595939,1404061,25000000,6.2,2017,Wonder Wheel,
The Fate of the Furious,-23991615,226008385,250000000,6.7,2017,The Fate of the Furious,
The Current War,-24020460,5979540,30000000,6.5,2017,The Current War,
All the Money in the World,-24886293,25113707,50000000,6.8,2017,All the Money in the World,
Stronger,-25788871,4211129,30000000,6.9,2017,Stronger,
Ferdinand,-26589620,84410380,111000000,6.7,2017,Ferdinand,
Life,-27765978,30234022,58000000,6.6,2017,Life,
The Snowman,-28299965,6700035,35000000,5.1,2017,The Snowman,
The Ottoman Lieutenant,-39759022,240978,40000000,6.6,2017,The Ottoman Lieutenant,
xXx: Return of Xander Cage,-40101587,44898413,85000000,5.2,2017,xXx: Return of Xander Cage,
Downsizing,-43550246,24449754,68000000,5.7,2017,Downsizing,
The Mummy,-44772105,80227895,125000000,5.4,2017,The Mummy,
Pirates of the Caribbean: Dead Men Tell No Tales,-57441124,172558876,230000000,6.6,2017,Pirates of the Caribbean: Dead Men Tell No Tales,
Blade Runner 2049,-57945841,92054159,150000000,8,2017,Blade Runner 2049,
Ghost in the Shell,-69436443,40563557,110000000,6.3,2017,Ghost in the Shell,
Justice League,-70975705,229024295,300000000,6.3,2017,Justice League,
Geostorm,-86299840,33700160,120000000,5.3,2017,Geostorm,
Transformers: The Last Knight,-86831317,130168683,217000000,5.2,2017,Transformers: The Last Knight,
King Arthur: Legend of the Sword,-135824934,39175066,175000000,6.7,2017,King Arthur: Legend of the Sword,
Valerian and the City of a Thousand Planets,-136010512,41189488,177200000,6.5,2017,Valerian and the City of a Thousand Planets,
Black Panther,500426566,700426566,200000000,7.3,2018,Black Panther,
Incredibles 2,408581744,608581744,200000000,7.6,2018,Incredibles 2,
Avengers: Infinity War,357815482,678815482,321000000,8.4,2018,Avengers: Infinity War,
Jurassic World: Fallen Kingdom,247719760,417719760,170000000,6.2,2018,Jurassic World: Fallen Kingdom,
Deadpool 2,214591735,324591735,110000000,7.7,2018,Deadpool 2,
The Grinch,195620950,270620950,75000000,6.3,2018,The Grinch,
A Star Is Born,179288866,215288866,36000000,7.7,2018,A Star Is Born,
Aquaman,175061807,335061807,160000000,6.9,2018,Aquaman,
A Quiet Place,171024361,188024361,17000000,7.5,2018,A Quiet Place,
Bohemian Rhapsody,164668042,216668042,52000000,8,2018,Bohemian Rhapsody,
Halloween,149342015,159342015,10000000,6.6,2018,Halloween,
Crazy Rich Asians,144532921,174532921,30000000,6.9,2018,Crazy Rich Asians,
Venom,113515506,213515506,100000000,6.7,2018,Venom,
Spider-Man: Into the Spider-Verse,100241310,190241310,90000000,8.4,2018,Spider-Man: Into the Spider-Verse,
The Nun,95450119,117450119,22000000,5.3,2018,The Nun,
Hotel Transylvania 3: Summer Vacation,87510016,167510016,80000000,6.3,2018,Hotel Transylvania 3: Summer Vacation,
I Can Only Imagine,76482352,83482352,7000000,7.3,2018,I Can Only Imagine,
Ocean's Eight,70218711,140218711,70000000,6.2,2018,Ocean's Eight,
Creed II,65715889,115715889,50000000,7.1,2018,Creed II,
Peter Rabbit,65253424,115253424,50000000,6.6,2018,Peter Rabbit,
Green Book,62080171,85080171,23000000,8.2,2018,Green Book,
Book Club,58566296,68566296,10000000,6.1,2018,Book Club,
Insidious: The Last Key,57745330,67745330,10000000,5.7,2018,Insidious: The Last Key,
The First Purge,56488745,69488745,13000000,5.2,2018,The First Purge,
Ant-Man and the Wasp,54648740,216648740,162000000,7.1,2018,Ant-Man and the Wasp,
The Mule,53804407,103804407,50000000,7,2018,The Mule,
Night School,48339130,77339130,29000000,5.6,2018,Night School,
Mamma Mia! Here We Go Again,45634935,120634935,75000000,6.6,2018,Mamma Mia! Here We Go Again,
Fifty Shades Freed,45407760,100407760,55000000,4.5,2018,Fifty Shades Freed,
Mission: Impossible - Fallout,42159104,220159104,178000000,7.7,2018,Mission: Impossible - Fallout,
Mary Poppins Returns,41958438,171958438,130000000,6.7,2018,Mary Poppins Returns,
Breaking In,40840590,46840590,6000000,5.4,2018,Breaking In,
The Equalizer 2,40084362,102084362,62000000,6.7,2018,The Equalizer 2,
Blockers,39311495,60311495,21000000,6.2,2018,Blockers,
Overboard,38316123,50316123,12000000,6,2018,Overboard,
Truth or Dare,37911015,41411015,3500000,5.2,2018,Truth or Dare,
BlacKkKlansman,34275340,49275340,15000000,7.5,2018,BlacKkKlansman,
Hereditary,34069456,44069456,10000000,7.3,2018,Hereditary,
A Simple Favor,33548586,53548586,20000000,6.8,2018,A Simple Favor,
Game Night,32179066,69179066,37000000,6.9,2018,Game Night,
Tag,26730625,54730625,28000000,6.5,2018,Tag,
The House with a Clock in Its Walls,26549695,68549695,42000000,6,2018,The House with a Clock in Its Walls,
Ralph Breaks the Internet,26091711,201091711,175000000,7.1,2018,Ralph Breaks the Internet,
Searching,25140957,26020957,880000,7.6,2018,Searching,
Christopher Robin,24215042,99215042,75000000,7.3,2018,Christopher Robin,
"Love, Simon",23826341,40826341,17000000,7.6,2018,"Love, Simon",
Uncle Drew,23469946,42469946,19000000,5.7,2018,Uncle Drew,
Second Act,23282227,39282227,16000000,5.8,2018,Second Act,
Life of the Party,23059911,53059911,30000000,5.6,2018,Life of the Party,
Winchester,21591816,25091816,3500000,5.4,2018,Winchester,
Slender Man,20569484,30569484,10000000,3.2,2018,Slender Man,
Teen Titans Go! To the Movies,19790236,29790236,10000000,6.8,2018,Teen Titans Go! To the Movies,
The Strangers: Prey at Night,19586708,24586708,5000000,5.2,2018,The Strangers: Prey at Night,
The Favourite,19366783,34366783,15000000,7.5,2018,The Favourite,
Instant Family,19363237,67363237,48000000,7.3,2018,Instant Family,
Super Troopers 2,17117396,30617396,13500000,6,2018,Super Troopers 2,
I Feel Pretty,16795601,48795601,32000000,5.5,2018,I Feel Pretty,
The Meg,15443742,145443742,130000000,5.6,2018,The Meg,
Sicario: Day of the Soldado,15072235,50072235,35000000,7.1,2018,Sicario: Day of the Soldado,
Den of Thieves,14947622,44947622,30000000,7,2018,Den of Thieves,
Sorry to Bother You,14293096,17493096,3200000,6.9,2018,Sorry to Bother You,
Forever My Girl,12876066,16376066,3500000,6.7,2018,Forever My Girl,
Goosebumps 2: Haunted Halloween,11700633,46700633,35000000,5.6,2018,Goosebumps 2: Haunted Halloween,
Eighth Grade,11539709,13539709,2000000,7.4,2018,Eighth Grade,
Peppermint,10418723,35418723,25000000,6.5,2018,Peppermint,
Unfriended: Dark Web,7866745,8866745,1000000,5.9,2018,Unfriended: Dark Web,
The Possession of Hannah Grace,7137422,14837422,7700000,5.2,2018,The Possession of Hannah Grace,
Upgrade,6977130,11977130,5000000,7.5,2018,Upgrade,
Midnight Sun,6761064,9561064,2800000,6.6,2018,Midnight Sun,
The Hate U Give,6719483,29719483,23000000,7.4,2018,The Hate U Give,
The Commuter,6343858,36343858,30000000,6.3,2018,The Commuter,
The 15:17 to Paris,6276286,36276286,30000000,5.2,2018,The 15:17 to Paris,
Unsane,6232899,7732899,1500000,6.4,2018,Unsane,
Mid90s,5662439,7362439,1700000,7.4,2018,Mid90s,
Hell Fest,5607431,11107431,5500000,5.5,2018,Hell Fest,
Traffik,5186156,9186156,4000000,6,2018,Traffik,
On the Basis of Sex,4622687,24622687,20000000,7,2018,On the Basis of Sex,
Death Wish,4017028,34017028,30000000,6.4,2018,Death Wish,
Smallfoot,3240103,83240103,80000000,6.6,2018,Smallfoot,
If Beale Street Could Talk,2915773,14915773,12000000,7.1,2018,If Beale Street Could Talk,
Every Day,1202076,6102076,4900000,6.4,2018,Every Day,
A Wrinkle in Time,478608,100478608,100000000,4.2,2018,A Wrinkle in Time,
Widows,402632,42402632,42000000,6.9,2018,Widows,
Can You Ever Forgive Me?,-1196135,8803865,10000000,7.1,2018,Can You Ever Forgive Me?,
Adrift,-3554988,31445012,35000000,6.6,2018,Adrift,
Tully,-3630245,9369755,13000000,7,2018,Tully,
Maze Runner: The Death Cure,-3967557,58032443,62000000,6.2,2018,Maze Runner: The Death Cure,
Boy Erased,-4211308,6788692,11000000,6.9,2018,Boy Erased,
Stan & Ollie,-4529765,5470235,10000000,7.2,2018,Stan & Ollie,
White Boy Rick,-4988812,24011188,29000000,6.4,2018,White Boy Rick,
Assassination Nation,-4994858,2005142,7000000,5.9,2018,Assassination Nation,
Gotti,-5656773,4343227,10000000,4.8,2018,Gotti,
Life Itself,-5897352,4102648,10000000,6.8,2018,Life Itself,
Operation Finale,-6387901,17612099,24000000,6.6,2018,Operation Finale,
The Spy Who Dumped Me,-6437931,33562069,40000000,6,2018,The Spy Who Dumped Me,
Destroyer,-7466676,1533324,9000000,6.2,2018,Destroyer,
Bumblebee,-7804411,127195589,135000000,6.8,2018,Bumblebee,
Hotel Artemis,-8291853,6708147,15000000,6.1,2018,Hotel Artemis,
Under the Silver Lake,-8453917,46083,8500000,6.5,2018,Under the Silver Lake,
Mary Queen of Scots,-8531501,16468499,25000000,6.3,2018,Mary Queen of Scots,
Ben Is Back,-9296816,3703184,13000000,6.7,2018,Ben Is Back,
Holmes & Watson,-11426374,30573626,42000000,3.8,2018,Holmes & Watson,
Vice,-12163718,47836282,60000000,7.2,2018,Vice,
Mile 22,-13891242,36108758,50000000,6.1,2018,Mile 22,
First Man,-14063455,44936545,59000000,7.3,2018,First Man,
Bad Times at the El Royale,-14160885,17839115,32000000,7.1,2018,Bad Times at the El Royale,
Billionaire Boys Club,-14998651,1349,15000000,5.6,2018,Billionaire Boys Club,
Alpha,-15142819,35857181,51000000,6.7,2018,Alpha,
Overlord,-16295156,21704844,38000000,6.6,2018,Overlord,
Beautiful Boy,-17350027,7649973,25000000,7.3,2018,Beautiful Boy,
Suspiria,-17516528,2483472,20000000,6.8,2018,Suspiria,
Rampage,-18971767,101028233,120000000,6.1,2018,Rampage,
The Happytime Murders,-19293548,20706452,40000000,5.4,2018,The Happytime Murders,
Johnny English Strikes Again,-20587830,4412170,25000000,6.2,2018,Johnny English Strikes Again,
The Darkest Minds,-21304309,12695691,34000000,5.7,2018,The Darkest Minds,
Red Sparrow,-22125495,46874505,69000000,6.6,2018,Red Sparrow,
Hunter Killer,-24232540,15767460,40000000,6.6,2018,Hunter Killer,
Kin,-24281904,5718096,30000000,5.8,2018,Kin,
Replicas,-25953571,4046429,30000000,5.5,2018,Replicas,
The Girl in the Spider's Web,-28158662,14841338,43000000,6.1,2018,The Girl in the Spider's Web,
Welcome to Marwen,-28236480,10763520,39000000,6.2,2018,Welcome to Marwen,
Les fr√®res Sisters,-34856944,3143056,38000000,7,2018,Les fr√®res Sisters,
Tomb Raider,-35749197,58250803,94000000,6.3,2018,Tomb Raider,
The Predator,-36975292,51024708,88000000,5.3,2018,The Predator,
Ready Player One,-37309828,137690172,175000000,7.5,2018,Ready Player One,
Fantastic Beasts: The Crimes of Grindelwald,-40444099,159555901,200000000,6.6,2018,Fantastic Beasts: The Crimes of Grindelwald,
Early Man,-41732456,8267544,50000000,6.1,2018,Early Man,
Skyscraper,-56579880,68420120,125000000,5.8,2018,Skyscraper,
Solo: A Star Wars Story,-61232488,213767512,275000000,6.9,2018,Solo: A Star Wars Story,
The Nutcracker and the Four Realms,-65141149,54858851,120000000,5.5,2018,The Nutcracker and the Four Realms,
Robin Hood,-69175372,30824628,100000000,5.3,2018,Robin Hood,
Mortal Engines,-84048960,15951040,100000000,6.1,2018,Mortal Engines,
Pacific Rim: Uprising,-90125475,59874525,150000000,5.6,2018,Pacific Rim: Uprising,
Avengers: Endgame,502373000,858373000,356000000,8.4,2019,Avengers: Endgame,
Frozen II,327373578,477373578,150000000,6.9,2019,Frozen II,
The Lion King,283638043,543638043,260000000,6.9,2019,The Lion King,
Joker,280451311,335451311,55000000,8.5,2019,Joker,
Captain Marvel,266829839,426829839,160000000,6.9,2019,Captain Marvel,
Star Wars: Episode IX - The Rise of Skywalker,240202542,515202542,275000000,6.6,2019,Star Wars: Episode IX - The Rise of Skywalker,
Toy Story 4,234038008,434038008,200000000,7.8,2019,Toy Story 4,
Spider-Man: Far from Home,230532085,390532085,160000000,7.5,2019,Spider-Man: Far from Home,
Jumanji: The Next Level,191831246,316831246,125000000,6.7,2019,Jumanji: The Next Level,
Aladdin,172559216,355559216,183000000,7,2019,Aladdin,
Us,155084580,175084580,20000000,6.9,2019,Us,
It Chapter Two,132593228,211593228,79000000,6.5,2019,It Chapter Two,
Knives Out,125363234,165363234,40000000,7.9,2019,Knives Out,
John Wick: Chapter 3 - Parabellum,96015687,171015687,75000000,7.5,2019,John Wick: Chapter 3 - Parabellum,
Glass,91048468,111048468,20000000,6.7,2019,Glass,
Hustlers,84963598,104963598,20000000,6.3,2019,Hustlers,
Downton Abbey,83854135,96854135,13000000,7.4,2019,Downton Abbey,
The Secret Life of Pets 2,78874395,158874395,80000000,6.5,2019,The Secret Life of Pets 2,
The Addams Family,76044905,100044905,24000000,5.8,2019,The Addams Family,
Little Women,68101214,108101214,40000000,7.8,2019,Little Women,
1917,64227644,159227644,95000000,8.3,2019,1917,
Good Boys,63140306,83140306,20000000,6.7,2019,Good Boys,
Rocketman,56368160,96368160,40000000,7.3,2019,Rocketman,
Once Upon a Time... in Hollywood,52502728,142502728,90000000,7.6,2019,Once Upon a Time... in Hollywood,
Escape Room,48005601,57005601,9000000,6.3,2019,Escape Room,
Yesterday,47286650,73286650,26000000,6.8,2019,Yesterday,
The Curse of la Llorona,45733739,54733739,9000000,5.3,2019,The Curse of la Llorona,
Annabelle Comes Home,44152591,74152591,30000000,5.9,2019,Annabelle Comes Home,
Scary Stories to Tell in the Dark,43947075,68947075,25000000,6.2,2019,Scary Stories to Tell in the Dark,
Ma,40896028,45896028,5000000,5.6,2019,Ma,
Shazam!,40371656,140371656,100000000,7.1,2019,Shazam!,
Five Feet Apart,38729221,45729221,7000000,7.2,2019,Five Feet Apart,
A Beautiful Day in the Neighborhood,36704055,61704055,25000000,7.3,2019,A Beautiful Day in the Neighborhood,
What Men Want,34611903,54611903,20000000,5.2,2019,What Men Want,
Pet Sematary,33724696,54724696,21000000,5.7,2019,Pet Sematary,
How to Train Your Dragon: The Hidden World,31799505,160799505,129000000,7.5,2019,How to Train Your Dragon: The Hidden World,
Zombieland: Double Tap,31123082,73123082,42000000,6.7,2019,Zombieland: Double Tap,
Uncut Gems,31023780,50023780,19000000,7.4,2019,Uncut Gems,
Angel Has Fallen,29030436,69030436,40000000,6.4,2019,Angel Has Fallen,
The Intruder,27419122,35419122,8000000,5.6,2019,The Intruder,
Harriet,26082155,43082155,17000000,6.5,2019,Harriet,
Queen & Slim,25808310,43808310,18000000,7.1,2019,Queen & Slim,
Crawl,25514193,39014193,13500000,6.2,2019,Crawl,
A Dog's Way Home,24004346,42004346,18000000,6.7,2019,A Dog's Way Home,
Ready or Not,22714231,28714231,6000000,6.8,2019,Ready or Not,
Ford v Ferrari,20024357,117624357,97600000,8.1,2019,Ford v Ferrari,
Jojo Rabbit,19370906,33370906,14000000,7.9,2019,Jojo Rabbit,
Child's Play,19208403,29208403,10000000,5.8,2019,Child's Play,
Happy Death Day 2U,19148130,28148130,9000000,6.2,2019,Happy Death Day 2U,
Countdown,19121766,25621766,6500000,5.4,2019,Countdown,
Midsommar,18426361,27426361,9000000,7.1,2019,Midsommar,
Isn't It Romantic,17791187,48791187,31000000,5.9,2019,Isn't It Romantic,
Booksmart,16680962,22680962,6000000,7.2,2019,Booksmart,
The Gentlemen,14471795,36471795,22000000,7.9,2019,The Gentlemen,
The Hustle,14417038,35417038,21000000,5.4,2019,The Hustle,
The Peanut Butter Falcon,14257151,20457151,6200000,7.6,2019,The Peanut Butter Falcon,
Unplanned,13005109,19005109,6000000,5.8,2019,Unplanned,
Fighting with My Family,11958886,22958886,11000000,7.1,2019,Fighting with My Family,
Late Night,11499454,15499454,4000000,6.5,2019,Late Night,
Dora and the Lost City of Gold,11477943,60477943,49000000,6.1,2019,Dora and the Lost City of Gold,
Brightburn,11300439,17300439,6000000,6.1,2019,Brightburn,
Just Mercy,11001502,36001502,25000000,7.6,2019,Just Mercy,
47 Meters Down: Uncaged,10260900,22260900,12000000,5,2019,47 Meters Down: Uncaged,
Last Christmas,10150750,35150750,25000000,6.5,2019,Last Christmas,
Black and Blue,10055313,22055313,12000000,6.3,2019,Black and Blue,
The Prodigy,8856291,14856291,6000000,5.8,2019,The Prodigy,
The Art of Racing in the Rain,8395642,26395642,18000000,7.6,2019,The Art of Racing in the Rain,
The Good Liar,7156058,17156058,10000000,6.6,2019,The Good Liar,
The Lego Movie 2: The Second Part,6806508,105806508,99000000,6.6,2019,The Lego Movie 2: The Second Part,
A Dog's Journey,6782371,22782371,16000000,7.5,2019,A Dog's Journey,
Stuber,6370452,22370452,16000000,6.2,2019,Stuber,
Jexi,1546159,6546159,5000000,6.1,2019,Jexi,
Bombshell,-237192,31762808,32000000,6.8,2019,Bombshell,
3 from Hell,-827051,2172949,3000000,5.5,2019,3 from Hell,
The Beach Bum,-1497400,3502600,5000000,5.5,2019,The Beach Bum,
After,-1861435,12138565,14000000,5.4,2019,After,
Blinded by the Light,-3098855,11901145,15000000,6.9,2019,Blinded by the Light,
21 Bridges,-4460243,28539757,33000000,6.6,2019,21 Bridges,
Rambo: Last Blood,-5180648,44819352,50000000,6.1,2019,Rambo: Last Blood,
Color Out of Space,-5234439,765561,6000000,6.2,2019,Color Out of Space,
Jay and Silent Bob Reboot,-5410510,4589490,10000000,5.7,2019,Jay and Silent Bob Reboot,
Pok√©mon: Detective Pikachu,-5894654,144105346,150000000,6.6,2019,Pok√©mon: Detective Pikachu,
Long Shot,-9683729,30316271,40000000,6.8,2019,Long Shot,
"Where'd You Go, Bernadette",-10801644,9198356,20000000,6.5,2019,"Where'd You Go, Bernadette",
Doctor Sleep,-13418288,31581712,45000000,7.4,2019,Doctor Sleep,
Shaft,-13639785,21360215,35000000,6.4,2019,Shaft,
Abominable,-14283610,60716390,75000000,7,2019,Abominable,
Tolkien,-15464846,4535154,20000000,6.8,2019,Tolkien,
Serenity,-16452955,8547045,25000000,5.4,2019,Serenity,
Motherless Brooklyn,-16722264,9277736,26000000,6.8,2019,Motherless Brooklyn,
Captive State,-19041685,5958315,25000000,6,2019,Captive State,
Richard Jewell,-22654458,22345542,45000000,7.5,2019,Richard Jewell,
The Angry Birds Movie 2,-23332884,41667116,65000000,6.4,2019,The Angry Birds Movie 2,
The Kitchen,-25819968,12180032,38000000,5.5,2019,The Kitchen,
Fast & Furious Presents: Hobbs & Shaw,-26043065,173956935,200000000,6.4,2019,Fast & Furious Presents: Hobbs & Shaw,
Cold Pursuit,-27861138,32138862,60000000,6.2,2019,Cold Pursuit,
Hellboy,-28096252,21903748,50000000,5.2,2019,Hellboy,
Men in Black: International,-29998193,80001807,110000000,5.6,2019,Men in Black: International,
Charlie's Angels,-30196923,17803077,48000000,4.7,2019,Charlie's Angels,
Spies in Disguise,-33242987,66757013,100000000,6.8,2019,Spies in Disguise,
The Goldfinch,-39667379,5332621,45000000,6.3,2019,The Goldfinch,
Ad Astra,-39811630,50188370,90000000,6.6,2019,Ad Astra,
The Kid Who Would Be King,-42209210,16790790,59000000,6,2019,The Kid Who Would Be King,
Midway,-43153198,56846802,100000000,6.7,2019,Midway,
Dumbo,-55233693,114766307,170000000,6.3,2019,Dumbo,
Godzilla: King of the Monsters,-59499862,110500138,170000000,6,2019,Godzilla: King of the Monsters,
Cats,-67833230,27166770,95000000,2.8,2019,Cats,
Maleficent: Mistress of Evil,-71070395,113929605,185000000,6.6,2019,Maleficent: Mistress of Evil,
Missing Link,-83350461,16649539,100000000,6.7,2019,Missing Link,
Alita: Battle Angel,-84289790,85710210,170000000,7.3,2019,Alita: Battle Angel,
Gemini Man,-89453230,48546770,138000000,5.7,2019,Gemini Man,
Terminator: Dark Fate,-122746923,62253077,185000000,6.2,2019,Terminator: Dark Fate,
Dark Phoenix,-134154026,65845974,200000000,5.8,2019,Dark Phoenix,
2020,-2417127,735082873,737500000,71.1,2020,2020,
Bad Boys for Life,114417855,204417855,90000000,6.6,2020,Bad Boys for Life,
Sonic the Hedgehog,61066470,146066470,85000000,6.5,2020,Sonic the Hedgehog,
The Invisible Man,57914050,64914050,7000000,7.1,2020,The Invisible Man,
Fantasy Island,19441782,26441782,7000000,4.9,2020,Fantasy Island,
The Grudge,11221803,21221803,10000000,4.2,2020,The Grudge,
Gretel & Hansel,10347654,15347654,5000000,5.3,2020,Gretel & Hansel,
Birds of Prey: And the Fantabulous Emancipation of One Harley Quinn,-341539,84158461,84500000,6.1,2020,Birds of Prey: And the Fantabulous Emancipation of One Harley Quinn,
The Hunt,-8187500,5812500,14000000,6.5,2020,The Hunt,
Bloodshot,-34978213,10021787,45000000,5.7,2020,Bloodshot,
Underwater,-62708922,17291078,80000000,5.8,2020,Underwater,
The Call of the Wild,-72657632,62342368,135000000,6.8,2020,The Call of the Wild,
Dolittle,-97952935,77047065,175000000,5.6,2020,Dolittle,
Grand Total,42444968504,1.86E+11,1.44E+11,19536.2,,Grand Total,